ءبد	أبد,تأبد,أبدا
ءبق	أبق
ءبن	إبان
ءبو	أب
ءبي	أبى,إباء
ءتو	إتاوة
ءتي	مأتى,مآت,مؤاتاة,إتيان,آتى,إيتاء,أتى,إتاء,آت,ءتي,مأتاة,تأت,أتي
ءثث	أثاث
ءثر	آثر,أثر,تأثر
ءجر	أجرة,آجر,استأجر,أجر
ءحد	أحد
ءخذ	تأخيذ,خد,مؤاخذ,آخذ,إخاذ,أخذ,اتخاذ,اتخذ,ءخذ,مؤاخذة
ءخر	أخير,متأخر,آخر,تأخير,تأخر
ءخو	أخ
ءدب	أدب
ءدو	أداة
ءدي	أدى,أدي
ءذن	مئذنة,أذن,مؤذن,استأذن
ءذي	أذى
ءرخ	أرخ,تاريخ,مؤرخ
ءرق	يرقان
ءرك	أريكة
ءزم	متأزم,أزمة,تأزم
ءسر	أسر,أسير,ءسر,ماسورة,أسرة
ءسس	مؤسسة,أسس,أساس,ءسس,مؤسس
ءسو	أسوان,أسي,أسى,ءسو,مأساة,إسوة,أسوة
ءصل	استأصل,تأصل,أصل
ءطر	إطار
ءفق	أفق
ءفل	ءفل
ءقط	أقط
ءكد	أكد,متأكد,تأكد
ءكل	تآكل,تأكل,أكل,مؤكل,تأكيل,مأكل,مؤاكلة,ءكل,مؤاكل,إكال,آكل
ءلف	ألف,مؤلف,ءلف,تألف,ائتلف,تآلف,ائتلاف
ءلل	ءلل,أل
ءلم	آلم,ألم,أليم
ءله	أله,الله,إله
ءلو	ألا
ءمر	تآمر,أمير,أميرة,أمر,تأمير,آمر,إمار,ائتمر,ايتمر,مؤامر,ءمر,ايتمار,ائتمار,مؤامرة,مأمور,مؤتمر,إمارة
ءمل	تأمل,أمل
ءمم	أمة,أم,إمام,أمام
ءمن	استئمان,أمين,إيمان,مؤمن,تأمين,أمانة,ءمن,استأمن,أيمن,أمان,آمين,آمن,أمن
ءمو	أمة
ءنس	إنسان,آنسة
ءنق	أنيق
ءني	استأنى
ءوب	ءوب,تأوب,آئب,مأوب,أوب,آب,تأويب,مؤوب
ءوف	آفة
ءول	ءول,إيالة,تأويل,آلة,أول
ءوه	تأوه
ءوي	مأوى,أوى,ءوي
ءيء	إياك,إيا
ءيد	أيد
ءيض	آض
ءين	أين
ءيي	أين
بءس	بئيس,بئس,تباءس,أبأس,بائس,ابتأس
بتت	بات
بتر	بتر,أبتر
بتل	بتول
بثث	انبث
بثق	انبثق
بحث	بحث,مباحثة,باحث,بحاث,تباحث,بحث
بحح	بح,بحاح
بحر	بحر
بخر	بخار,بخور
بخل	أبخل,بخل,بخيل
بدء	مبتدأ,ابتدأ,مبتدئ,ابتداء,بدأ,بداية
بدد	استبد,بد
بدر	بدر
بدل	تبديل,بادل,بدال,إبدال,استبدال,بدل,أبدل,تبدل,بدلة,مبادلة,بديل,استبدل,بدل,تبادل
بدن	بدن
بدو	بدا
بذر	بذر
بذل	ابتذل,مبتذل,بذلة
برء	برئ,أبرأ,برهان,برء,براءة,برهن,برأ,بريء
برد	بارد,بردان,أبرد,برادة
برر	بر,تبرير
برز	أبرز,برز,مبارز,مبارزة,برز,بارز
برغش	ابرغش
برق	برقية,برق,أبرق
برقع	برقع
برك	بركة,برك,تبارك,تبريك,مباركة,مبارك,برك,ركبة
برمج	
برنس	تبرنس,برنس,برنس
بره	برهن,برهان
برهن	برهن,برهان
بري	بارى
بزبز	بزبز
بزز	ابتز,ابتزاز
بزم	إبزيم
بسر	بسر,بسر
بسس	بس
بسط	بساط,بسط,بسيط,أبسط,انبسط
بسم	ابتسم,تبسم,ابتسامة,بسم
بشر	بشري,مباشر,باشر,بشر,بشرى
بصر	بصر,بصير,أبصر
بصق	بصق
بطء	بطيء,بطأ,بطء,إبطاء,أبطأ,بطؤ
بطر	بيطار
بطل	بطالة,أبطل,بطل,باطل
بطن	بطانة,باطن
بعث	بعث,مبعوث
بعد	أبعد,بعد,استبعد,بعيد,ابتعد,بعد,ابتعاد
بعض	بعض,بعوضة
بغي	ابتغى,بغى,انبغى,بغي,بغي
بقق	بوق
بقل	باقلا,بقال
بقي	باق,بقية,أبقى,بقي
بكر	مبكر,بكرة,بكر,باكر
بكل	بكلة
بكم	أبكم
بكي	تباكى,بكي,بكى
بلج	ابلاج
بلد	بلدية,بلد,بلاد,تبلد,تبليد,بلد,تبالد
بلس	إبليس
بلط	بلاط
بلع	أبلع,ابتلع,بلع
بلغ	أبلغ,مبالغ,بليغ,بلاغ,تبليغ,مبالغة,إبلاغ,بلغ,بلغ,مبلغ,بالغ
بلل	بل
بله	أبله
بلو	بلا,لامبالاة,بالى
بلي	لامبالاة,مبتلى,ابتلى,مبتل,بالى
بني	بان,بناية,بناء,بني,بنيان,بنى,مبنى,مبنا,بنية
بهت	بهتان,بهت
بهج	أبهج,بهج,بهيج,ابتهج,بهج
بهر	بهار
بهم	أبهم,بهم,بهيمة,إبهام
بوء	بيئة,باء
بوح	باح,اباحي
بور	بار,بور
بوق	بوق
بول	تبول,بال,بول
بون	بان
بيت	بيت
بيض	ابيض,مبيض,أبيض
بيع	بائع,أباع,بيع,ابتاع,بيع,مبيع,بياع,ابتياع,باع
بين	بان,مبان,بين,بينونة,بيان,بين
تبب	تب
تبع	اتباع,تبع,اتبع,تباع,تتبع,تبع,تابع,متابعة
تبغ	تبغ
تجر	تاجر,متجر,تجر
تحت	تحت
تحف	متحف
ترجم	ترجمان,مترجم,ترجم,ترجم,ترجمة
ترس	تترس
ترك	ترك
تسع	تسع,تسعة
تشر	
تعب	أتعب,تعبان,تعب,إتعاب,متعب,تعب
تعس	أتعس
تفه	تفاهة
تقن	أتقن
تقي	
تلل	تل
تلو	تلا,تال
تمتم	تمتم
تمم	تم,تمام,تام,أتم
توب	تاب
توج	توج
توه	تاه
تيح	أتاح
ثءب	تثاءب
ثءر	ثأر
ثبت	تثبت,ثابت,ثبت,ثبت,أثبت
ثبر	ثابر,ثبر
ثبط	ثبط
ثدي	ثديي
ثرثر	ثرثر
ثرد	ثريد
ثرو	ثروة
ثقب	ثقب,تثقيب,ثقب,ثقبة
ثقف	ثقافة,مثقف,ثقف
ثقل	ثقل,مثقال,أثقل,ثقيل
ثلث	ثلاثة,تلاتة,ثلث
ثلج	ثلج
ثلل	ثلة
ثمر	ثمرة,أثمر,استثمر,ثمر
ثمل	ثمل
ثمن	ثمن,تمانية,ثمانية
ثنن	مثانة
ثني	اثنان,أثناء,مثانة,ثانوي,مشناه,اتنين,ثانية,ثنى,تثنية,مستثنى,تبن,أثنى,ثني,انثناء,انثنى,استثنى,تثنى,مثنى,اثنى,تثن,إثناء,استثناء,اثنونى,أثني,ثني,اثناء,ثان
ثوب	ثوب,ثوب
ثور	ثار,مثير,ثورة,أثار
جبب	جبة
جبر	جبر,جابر
جبل	جبل
جبن	جبن,جبان
جبه	جبهة
جثث	جثة
جحر	جحر
جحم	جحيم
جدد	تجدد,جدي,جد,جدد,جاد,نجد,جديد,جدد
جدر	جدير,أجدر
جدل	جادل,جدول,مجادلة,جدال
جدو	جدوى,أجدى
جذب	جاذب,انجذاب,أجذب,جذاب,جذب
جذر	جذر
جرء	جريء,جرؤ,أجرأ
جرب	تجربة,أجرب,جرب
جرثم	اجرنثم
جرح	جراحة,مجروح,تجريح,جرح,جرح,جراح
جرد	جرد,جريدة,أجرد
جرر	جر
جرع	جرع,جرعة
جرف	انجراف,انجرف,مجراف,جرف,جرف,مجرفة,تجريف,جرافة
جرم	جرم
جرمز	اجرمز
جري	إجراء,مجرى,أجرى,جرى
جزء	جزء
جزح	جزح
جزر	جزيرة,جزر
جزع	جزع
جزي	جزى,جزاء
جسد	جسد
جسس	جاسوس,جواسيس,جاسوسة
جسم	أجسم,جسيم,مجسمة
جشع	جشع
جصص	جصص,جص
جعب	جعبة
جعل	جعل
جفف	جاف,أجف
جفل	مجفل
جلب	جلب
جلبب	جلبب,جلباب
جلد	أجلد
جلس	مجلس,جلس,جلس,جلسة
جلعب	اجلعب
جلعد	اجلعد
جلفع	اجلنفع
جلل	أجلة,جليل,جلالة,جلائل,أجلاء,جلل,أجل,جلال,مجلة,جل
جمد	مجمد,جمد
جمع	إجماع,مجموع,جمع,مجموعة,أجمع,اجتماع,جمعي,جميع,تجمع,جامع,اجتماعي,جمع,مجامعة,استجماع,اجتمع,مجتمع,جمعة,الجمعة,اجتماعية,جماع,تجميع,جامعة,استجمع
جمل	جمال,جمل,جمل,مجاملة,تجامل,إجمال,تجميل,تجمل,جملة,جميل,جامل,أجمل
جمهر	جمهورية,جمهور,جمهر
جنب	اجتنب,جنب,جانب,جنوب,تجنب
جنح	جناح
جنز	جنازة
جنس	تجنس,تجانس,جانس
جنن	جنة,جان,جنين,مجنون
جني	جان
جهد	مجتهد,إجهاد,جهد,جهد,مجاهدة,جاهد,اجتهد,اجتهاد,أجهد,جهاد,مجاهد
جهر	جهر
جهز	جهز,جهاز
جهل	جهل,مجهول,تجاهل,أجهل,استجهل,جاهل,جهل
جوب	أجاب,جواب
جود	جواد,أجود,جيد
جور	جار,جوار,مجاورة,جاور
جوز	إجازة,جاوز,مجوز,مجاز,جاز
جوع	جيعان
جوف	أجوف
جول	مجال,جوال,تجول
جيء	جاء,جيء,مجيء,جوا
جيب	جيب
جيد	جيد
جيش	جيش,جيش
حبب	حبب,أحب,محب,استحباب,تحبب,محبوب,تحبيب,حبوباللقاح,تحاب,استحب,حبة,حبيب,حبب,حبيبة,حب,محبة,تحابب,مستحب
حبر	حبر
حبس	حبس,محبس,حبس
حبط	حبط,حبط,أحبط
حبل	أحبل,حبل,حبلى
حتت	حتى
حجب	محجوب,حجب,حاجب,حجاب
حجج	حج,حجة,حاج
حجر	حجر,حجرة,حجيرة
حجز	حجز,حاجز
حجم	حجم
حدب	حدب,احدودب
حدث	حدوث,أحدث,حديث,حدثاء,حداث,حادثة,حوادث,تحديث,محادث,حدث,تحدث,أحاديث,حدث,تحادث,حادث,محادثة,حدثان,حداثة
حدد	حاد,محدد,حديد,أحد,حد,حدوة,حدد
حدق	احدودق,حديقة
حدو	حدا,تحد,حدو,تحدى
حذر	حذر,حذر,تحذير
حذف	حذف
حذو	حذاء
حرب	حراب,محاربة,احتراب,احترب,محراب,تحارب,محارب,حرب,حرب,حرباء,حارب
حرث	حرث
حرجم	احرنجم
حرر	أحر,حار
حرس	حارس,حرس
حرشف	احرنشف
حرص	حريص,حرص,أحرص
حرض	تحريضي,تحريض,حرض
حرف	تحرف,حرفة,حرف,انحرف,محترف
حرفز	احرنفز
حرق	حراق,حرق
حرك	حرك,حركة,محرك,حرك
حرم	احترم,محرمة,احترام,إحرام,حريم,حرم,استحرام,حرام,تحريم,محرم,أحرم,استحرم,تحرم,حرم
حزب	حزب,حزب
حزم	حزام,حزم,حزمة
حزن	حزن,أحزن,حزين
حسب	حسب,تحسب,احتسب,محاسبة,حاسب,حسب,تحاسب,حساب,حسابة,احتساب,حسبان,محسبة,حاسوب
حسد	حسد
حسر	حسر
حسس	حس,حساس,حاسة,أحس
حسن	تحسين,حسان,أحسن,استحسان,حسنة,hazaña,إحسان,محسن,تحسن,حسن,حسن,استحسن,حسناء
حشد	حشد,احتشاد,احتشد,حشد,تحشيد,تحشد
حشر	حشرة,حشر
حشش	حشيش
حصد	حصد,حصاد
حصر	محاصر,محاصرة,حصار,حصر,حاصر,حصر
حصف	حصف
حصل	محصول
حصن	حصن,حصان,أحصن
حصو	حصى,حصوة,أحصى,حصاة,حصو,إحصاء
حصي	حصي,حصى,حصوة,أحصى,حصاة,إحصاء
حضر	استحضار,حضر,تحضير,احتفاظ,إحضار,استحفاظ,أحضر,محاضرة,حضرة,حفاظ,إحفاظ,محاضر,حضر,حاضر,تحفيظ,استحضر
حضض	حضض,حض,حضيض
حطب	حطب
حطط	حط,حطة,محطة
حطم	حطم,حطم,حطام
حظر	حظر
حظظ	محظوظ,حظ
حظو	حظي
حظي	حظي
حفد	حفيدة,حفيد
حفر	حفر,حافر,حفار
حفظ	محافظة,احتفظ,حفظ,حافظة,حفظ,استحفظ,محافظ,تحفظ,حافظ,أحفظ,محفظة
حفف	حف
حفل	حافلة,حفل,محفل,احتفل,حفلة
حقد	حقد
حقر	أحقر,حقير
حقف	احقوقف,حقف
حقق	حاقق,حقق,حقق,استحقاق,حقاق,حقا,محاققة,حقيقي,حق,محقق,تحقيق,استحق,حقيق,أحق,حقيقة,حاق,محاقة,إحقاق
حكر	احتكار,احتكر
حكك	حكة
حكم	حكمي,تحكم,محاكمة,حكمة,أحكم,حكم,محكمة,تحكيم,حكيم,حكومة,حكم,حاكم
حكي	حكاية
حلب	حلب,حلاب,حليب,حلب
حلف	حلف
حلق	حلق,حلقوم,حلاق
حلل	حلل,حلال,احتل,حل
حلم	محتلم,حلم,احتلام,احتلم,حالم,حلمة,حلم
حلو	أحلى,حلوى
حمد	حمد,حمد,إحماد,محمد,حميد,محمود,أحمد,حامد
حمر	احمر,أحمر,حمار,احمرار,حمر,حمر,حمراء
حمس	حماس
حمض	حماض
حمق	حمق,حمق,أحمق
حمل	إحمال,احتمالا,أحمل,تحمل,حامل,حمل,استحمال,احتمال,تحامل,استحمل,محتمل,انحمل,تحميل,انحمال,حمل,حملة,احتمل
حمم	أستحمى,حمام,استحم
حمو	حماة,محامي
حمي	حمى,حامى,محام
حنف	حنف,حنيف,حنفية,حنف
حنو	حنا,حنى
حني	حنا,حنى
حوج	حوائج,احتاج,حاجة
حور	حوار,حارة,حور,محور
حوش	حوش
حوض	حوض
حوط	حاط,محيط,تحويط,محاوطة,احتياط,أحاط,حوط,إحاطة,حوط,احتاط,تحوط,حاوط,حواط
حوك	حوك,حاك
حول	أحيل,أحول,حول,احول,حالة,استحال,محيل,حاول,مستحيل,حوالي,حالا,حيال,حيلة,حال,أحال
حوي	حية,تحوى,حوي,محتوى,حوى,حي,احتوى,حواية
حير	حيرة,حير
حيل	أحيل
حيو	حيوت,أحيا,حياة,حيا,حيوان,تحية,حي,حيو,استحيا,استحى,حياء,إحياء,حيوات,استحاء,استحياء
خبء	خبء,خبأ,مخبأ,اختبأ
خبر	خبر,أخبار,تخبر,مختبر,تخابر,خابر,خبر,أخبر,استخبر,اختبر
خبز	خبز,خباز
خبط	تخبط,خبط
ختم	ختم,خاتم,ختم
ختن	ختان,اختتن,ختن,مختون,اختتان,ختن
خجل	خجل,تخجيل,خجل
خدد	خد
خدر	تخدر,خدر,تخدير,مخدر,خدر,أخدر
خدش	خدش
خدع	خدع
خدم	مستخدم,خدمة,استخدام,خدم,خادم,استخدم
خذل	خذل,خذل
خرء	خرئ,خرا
خرب	خرب,خراب
خرج	خارج,خريج,خرج,مخرج,خرج,إخراج,أخرج,خروج
خرر	خر
خرص	خرص
خرط	خرط,انخرط,خريطة,اخروط
خرطم	خرطوم,اخرنطم
خرع	اخترع
خرف	خريف,خروف
خرق	اختراق,خرق,اخترق,خرق,خرقة
خرمس	اخرنمس
خرمص	اخرمص
خزن	خزن,خزينة,خزانة,مخزن
خسء	خسئ,خسأ
خسر	خسر,خسارة,خسر
خسف	خسف,خسف
خشب	تخشب,اخشوشب,خشب,خشب,تخشيب
خشن	خشونة,خشن,أخشن,اخشوشن
خشي	خشي
خصب	أخصب
خصص	خصص,خاص,خصوص,خصص
خصف	خصف
خصل	خصلة
خصم	خصم
خصي	خصى
خضر	اخضر,اخضوضر,خضرة,أخضر,اخضار
خضع	خضع,خضوع,اخضوضع
خضل	أخضل,تخضيل,اخضلال,خضل,اخضل,إخضال,خضل
خطء	خطئ,خطيئة
خطب	خاطب,خطبة,خطاب
خطر	خطير,خاطره,خطر,أخطر
خطط	متكتل,مخطط,خطط,خطة,خط
خطف	تخطف,خطف,اختطاف,اختطف,خطف
خطم	خطم
خطو	خطوة
خفت	خفت
خفش	أخفش
خفض	تخفيض,انخفاض,أخفض,انخفض,خفض
خفف	خف,أخف,خفف,خفف,خفيف
خفي	اختفى,استخفى,تخفى,أخفى,خفي,خفي
خلج	خليج
خلد	خلد,أخلد,خلد
خلص	خلص,خالص,أخلص,خلص,مخلص,خليص
خلط	اختلط,خلط,خالط
خلع	خلع
خلف	خليفة,اختلف,خالف,خلف,مختلف,خلف
خلق	أخلق,خلقة,تخليق,خلق,خالق,خلاق,خلق,خليق
خلل	إختلال,خل
خلو	خلا,خلى,خلية,خال
خمر	تخامر,خمار,خامر,خمر,اختمر,تخمر,مخامرة,إخمار,خمر,أخمر,اختمار
خمس	خمسة,خمس
خنب	خنب
خنث	مخنث
خور	خور
خوص	خوص
خوف	تخوف,خوف,خائف,إخافة,خاف,تخويف,أخوف,خوف,أخاف
خول	خول,خال
خون	خيانة,خوان,خون,خان,خون,خؤون,خائن
خيب	خاب
خير	اختيار,خير,خير,اختار,خيرة,مختار
خيط	خياط,خيط
خيل	تخيل
خيم	مخيم,خيمة
دبب	دب,دابة,دبابة
دبر	دبر,دبر,تدبير,أدبر,دبور,دابر,تدبر
دثر	دثر,مندثر
دجج	دجاجة
دجل	دجال
دحرج	دحرج
دحض	دحض
دحو	أدحوة,إدحي,إدحية,دحو,أدحي,أدحية,دحو
دخل	مدخل,داخل,تدخل,دخل,مداخلة,تداخل,مداخل,أدخل
دخن	تدخين,دخان,دخن
درب	تدريب,درب
درج	درجة,دراجة,درج,دارجة,تدريج
درر	أدر,دار,در,استدر
درس	درس,درس,دراس,إدريس,مدرسة,مدارس,مدرس,دراسة,تدريس
درك	مدرك,أدرك
دري	أدري
دسر	دسار
دعر	دعارة
دعع	دع
دعو	دعوى,استدعى,تداع,دعاء,تداعى,ادعى,استدعاء,مدع,مدعى,دعا
دفء	دافئ,مدفأة,استدفأ,دفئ,دفأ,مدفأ,دفيء,أدفأ,دفاية
دفع	مدفع,دافع,دفع
دفف	دف
دفق	دفق,اندفق
دفن	دفن
دقع	دقع
دقق	دقة,دقاق,أدق
دكن	داكن,أدكن
دلع	اندلع
دلك	دلك
دلل	استدل,دليل,دل
دمر	تدمر,دمر,دمر
دمغ	دماغي,دماغ
دمن	أدمن,إدمان,مدمن
دمو	
دمي	دمية,دمي
دنء	دنيء,أدنأ
دندن	دندن
دنو	دني,أدنى,دنيا
دني	دني,أدنى,دنيا
دهش	أدهش,مدهش,دهش,إدهاش,دهشة
دهن	دهن,دهان,دهن
دور	دور,دار,دور,مدير,دوار,دورة,تدور,استدار,مستدير,أدار,داور,دائرة,إدارة,مدور
دول	تداول,دولة,دول,متداول
دوم	دائم,أدوم,دام
دون	دون,مدوان,ديوان,مدونة
دوي	دوي,داء,دواة,دوي,دواء,داوى,دوى
دير	دير,دير
دين	متدين,أدان,دين,دان
ذءب	ذئب
ذبب	ذبابة,ذباب
ذبح	مذبحة,ذبح
ذبذب	تذبذب
ذخر	ذخر,ذخيرة
ذرء	ذرأ
ذرر	ذر,ذرية,ذرة
ذرع	ذراع,ذريعة,ذريع,تذرع,ذرع
ذرو	ذرا,ذرة
ذري	ذرى,ذرة
ذكر	تذكرة,تذكار,ذكر,مذاكرة,تذكر,استذكر,ذاكرة,ذاكر,تذاكر,ذكري
ذكو	أذكى
ذكي	ذكي,أذكى
ذلعب	اذلعب
ذلل	ذيل
ذلي	اذلولى
ذمر	تذمر
ذنب	مذنب,أذنب
ذهب	ذهب,أذهب,ذهب,تمذهب,مذهب
ذهل	ذهل
ذهن	ذهن
ذوق	ذوق,تذوق,ذاق
ذيع	أذاع
ذيل	ذيل
ذيو	ذكي
رءس	رأس,رءس,رئيس
رءي	رأى,رءي,رأي,مرآة,أرى,مراية
ربب	الرب,رب,ربب
ربح	ربح,ربح
ربض	ربض
ربط	ربطة,رابطة,ربط,تاءمربوطة,مرابط,رباط,ربط
ربع	ربيع,أربعة,مربع,رباع,رباعي,ربع
ربك	ارتبك,مربك,مرتبك,أربك
ربو	مترب,مربى,ربا,ربى,تربية
رتب	أرتب,رتبة,رتب,رتيب,ترتب,ترتيب,مرتب,راتب,رتب
رتعس	
رتل	رتل
رثعن	ارثعن
رجج	رج
رجح	مرجيحة,راجح,رجح
رجحن	ارجحن
رجس	رجس
رجع	مرجع,رجع,رجع,راجع,استرجع,مراجع,تراجع
رجف	رجف,رجف
رجل	ترجل,استرجل,راجل,رجل,ارتجل
رجم	رجم
رجو	ارتجى,رجا
رحب	أرحب,رحب,مرحبا
رحض	رحض
رحل	رحل,رحلة
رحم	رحم,رحيم,رحمن,أرحم,رحمة
رخص	رخيص,أرخص,رخصة
رخي	أرخى
ردء	أردأ,رديء
ردد	رد,تردد,استرد,ردد,راد,ترادد,رادد,ردد,تراد,أرد,ارتد
ردف	رادف,مرادف,ردف,أردف
رده	ردهة
ردي	رداء,ردي,ردى,ردي,ارتدى,ترد,تردى
رذذ	رذذ,رذ
رزز	رزز
رزق	رزق,ارتزق,رزق,استرزق,مرزوق
رسل	أرسل,رسل,مراسل,رسالة,رسول,كتابةالرسائل
رسم	رسم,مرسم,رسام
رسو	رسا
رشد	رشيد,راشد,رشد,أرشد
رشش	رش,مرشة
رشو	رشا
رصد	مرصاد
رصص	رصاصة,رصاص
رصف	رصف
رضع	أرضع
رضو	رضي
رضي	رضا,أرضى
رطب	راطب,أرطب,رطيب,رطب
رعد	ارتعد,رعد
رعي	رعية
رغن	أرغن
رفرف	رفرف
رفض	رفض
رفع	ارتفع,أرفع,ترفع,رفع,رفيع,رفع,رافع,رفاع,ارتفاع,ترافع
رفف	رف
رفق	رفيق,رافق,رفق,رفق,رفقة,مرفق
رقب	راقب,رقب,ترقب,رقبة,مراقب,رقب
رقد	رقد
رقص	رقص,مرقص,رقاصة,رقصة,رقص
رقع	برقع
رقق	أرق,رق,رقيق
رقم	رقم,ترقيم
ركب	ركب,راكب,مركبة,مركب
ركز	مركز,ركز
ركس	أركس,ركس
ركض	ركض
ركع	ركعة,ركع
ركل	ركلة,ركل
رمح	رمح
رمز	رمز
رمي	رمى
رهب	رهيب,راهب,إرهاب,رهب,أرهب
رهف	أرهف,مرهف,رهيف,رهف
رهق	رهق
رهم	مرهم
رهن	رهين,رهينة
روب	راب
روح	ارتاح,تراوح,أراح,مرتاح,أروح,استراح,مروحة,مريح,روح,استراحت,روحاني
رود	أراد
روش	مروش
روض	رياضيات,رياضة
روغ	راغ
روق	رونق
روم	رام
روي	روى
ريب	راب
ريح	ريح
ريش	ريشة
ريق	ريق
رين	رين,ران
زبب	أزب
زبد	زبد,زبدة
زبر	زبرة,زبور
زبط	زبط
زبل	زبل,زبال
زجج	زجاجة,زجاج
زحر	زحر
زحف	زحف,زحف,زحافة
زحل	زحل,زحليقة
زحم	ازدحم,زحم,مزدحم
زخخ	زخ,زخة
زخرف	زخرف,مزخرف,تزخرف
زرد	ازدرد,زرد,زرد
زرر	زر
زرع	زراعي,زرع,زراعة,زريعة,مزرع,مزرعة,زرع
زرق	ازرق,أزرق
زركش	مزركش,زركش
زعج	مزعج
زعر	أزعر
زعم	زعم
زكم	زكام
زكو	أمازيغ,زكاة
زلزل	زلزال,زلزل,تزلزل
زمت	متزمت,تزمت
زمر	استزمر,زمر
زمل	زميل
زمن	زمان,تزامن,زمن
زنب	زنبور
زنر	زنر,تزنر
زني	زان,زانية
زهد	زاهد,أزهد,زهد
زهر	أزهر,زهر,زهر,زاهر,مزدهر,زهرة,ازدهر
زهق	زهق
زوج	زوج,زوج,تزوج,ازدوج,ازدواج,مزدوج,زوجة
زود	زود,تزويد
زور	زار,زيارة,زائر
زول	زال,أزال
زوي	زاوية,تزوى,زوى,انزوى
زيد	زاد,أزيد,زائد,زيد,ازداد
زيغ	زيغ,زاغ
زيف	زائف,أزيف
زيل	زال
زين	زينة,ازدان,زين,زين,تزين,زان
زيي	زيي,ازاي,زي
سءل	مسؤول,سائل,مسئله,تساءل,سؤال,مسألة,سءل,سأل,ساءل
سءم	أسأم,سئم
سبب	سبب,سبب,تسبب
سبت	السبت
سبح	سبح,مسبح,تسبيح,سبح
سبر	سبورة
سبع	أسبوع,سبع,سبعة
سبغ	أسبغ
سبغل	اسبغل
سبق	أسبق,مسابقة,سابق,سبق
سبكر	اسبكر
سبل	سبيل,شلوار
ستر	ستارة,سترة
سجد	سجد,مسجد,سجد,سجادة
سجع	سجع
سجل	
سجن	سجين,سجن,سجن
سجو	سجا
سحب	سحب,انسحاب,انسحب,سحب
سحر	سحر,ساحر,ساحرة
سحل	سحلية
سخر	سخر,ساخر,مسخرة
سخط	سخط,سخط,أسخط
سخن	سخن,ساخن,أسخن
سدر	سدر
سدس	سدس,مسدس
سدم	سديم
سرب	سراب,تسريب,سرب,سرب,تسرب
سربل	سربال
سرح	مسرح,سراح
سرر	أسر,سرة,سرية,سار,تسرى,سر,سرير
سرع	مسرع,سرعة,سريع,سرع,أسرع,سرع
سرف	أسرف
سرق	سارق,سرق
سرو	تسرى
سري	تسرى,أسرى,سرية,إسراء
سطر	مسطرة,سطر
سعد	سعد,سعادة,ساعد,أسعد,سعد
سعر	سعر
سعل	سعل
سعي	مسعى,سعى
سفح	مسفوح
سفد	سفد
سفر	سافر,أسفر,سفر,سفر
سفط	سفط
سفك	سفك
سفل	أسفل
سفن	سفينة
سقط	أسقط,تساقط,سقط
سقف	سقف
سقي	استسقى,ساق,سقى
سكت	سكت,ساكت
سكر	سكر
سكك	سكة
سكن	سكن,سكين,تسكن,سكن,أسكن,سكان,ساكن,تساكن
سلب	سلبي
سلح	سلح,تسلح,سلح
سلخ	مسلخ,سلخ,سلخ
سلس	أسلس,سلس
سلسل	سلسل,سلسل,مسلسل,سلسلة
سلط	لاسلطوي,سلطة,سلطوية,لاسلطوية,سلطوي,سلط,سلط
سلطح	اسلنطح
سلطع	اسلنطع
سلع	سلعة
سلف	سلف,سلف
سلق	سلق,سليقة,تسلق
سلك	أسلك,سلك,مسلك
سلل	مسلول
سلم	سلم,إسلام,سلم,استسلام,سالم,تسلم,سلمات,سلام,الإسلام,سلمان,استسلم,سليم,مسلم,أسلم,سلامة,استلم
سلو	تسلى,مسل
سلي	مسل
سمت	سمت
سمح	أسمح,سمح,متسامح,تسامح,سمح
سمر	مسمار,أسمر,سمير
سمط	سمط
سمع	سمع,تسامع,استمع,سمع,تسمع,أسمع
سمك	سمك,أسمك,سمكة
سمم	سم,تسمم,سموم
سمن	سمين,أسمن
سمو	سماء,سمي,أسمى,سما,سام
سمي	سمي
سند	ساند,أسند,استند,تساند,سند
سنن	سنة,أسن,مسن,سن
سهل	سهلا,سهل,سهل,أسهل
سهم	ساهم
سهو	سها
سوء	أسوأ,سوء,سوء,استاء,أساء,ساء,سيئ
سوح	ساحة
سود	سيادة,مسود,أسود,سيد
سور	سورة,سور
سوط	سوط
سوف	مسافة,سوف
سوق	تسوق,ساقة,ساق,سائق
سول	سول
سوي	تساوى,مساواة,مستوى,سوى,مساو,سوي,ساوى,أسوى,استوى,سوي
سيب	سيب
سيج	سياج
سيح	سياحة,ساح,سائح
سيخ	سيخ
سير	مسيرة,سيرة,سائر,سار,مسار,سيارة
سيطر	سيطر
سيل	سيل,سال,سائل,سيل
شءم	تشاءم,مشأمة
شءن	شأن
شبب	شاب,شب
شبث	شبث
شبح	شبح
شبك	شباك,شبكة
شبه	اشتباہی,اشتباهی,شبه,شبه,تشابه
شتم	شتم
شتو	شتاء,شتو
شجر	اشتجر,شجر,تشاجر,تشجر,أشجر,شاجر,شجر
شجع	شجيع,شجاع,أشجع,شجاعة,تشجيع,شجع,مشجع,شجع
شحب	شاحب,أشحب
شخخ	شخان
شخص	تشخص,شخص,أشخص,شخص
شدد	شد,أشد,شدة,شدد,شديد
شذذ	شاذ
شرب	شراب,شربة,شارب,شرب,مشرب
شرح	شرح
شرط	أشرط,شريط,شرط
شرع	تشريعي,مشروع,شرع,شرع,شراع,شارع,شريعة,تشريع
شرف	شرف,شريف,تشرف,شرف,أشرف,شرفة
شرق	شرق,مشرق
شرك	شرك,شريك,شارك,شراك,أشرك,شرك,اشترك,شركة,تشارك
شرم	شرم
شري	شري,اشترى,شرى
شزر	شزر
شطء	شاطئ
شطر	شطيرة
شعب	شعب,شعبة
شعر	إشعار,شعار,استشعر,شعر,أشعر,استشعار,شعر
شعع	شع
شعل	اشتعل,شعله,شعلاء,أشعل,شعل
شغف	شغف,شغف,انشغف
شغل	شغل,تشاغل,اشتغل,انشغل,أشغل,شاغل,مشغول,شغل
شفع	شفع
شفف	أشف,شفاف
شفق	شفق,شفقة
شفه	شفة,شفه
شفو	
شفي	مستشفى,بالهناءوالشفاء,شفى
شقر	أشقر
شقق	اشتق,اشتقاق,انشقاق,شقة,انشق
شقو	شقوة,شقاء
شكر	شكر,شكر,تشكر,شاكر
شكك	شك
شكل	شكل,أشكل
شكو	شكا
شمءز	اشمأز,مشمئز
شمس	شامس,شمس,أشمس
شمع	شمع
شمل	شمال,اشتمل
شمم	شم
شنق	شنق,شنق
شهد	شاهد,مشهود,مشهد,أشهد,شهد,شهد,استشهد
شهر	أشهر,اشتهار,شهير,اشتهر,شاهر,شهر,شهر,مشهور
شهل	أشهل,شهل,شهلاء
شهم	شهم
شهو	شهيةطيبة
شوء	شاء
شوب	شاب
شور	أشار
شوس	أشوس
شوش	شاش
شوف	شوف
شوق	تشويق,شاق,تشوق,شوق
شوك	شوكة,شوك
شوه	شاة,شاء
شوي	شي,شوى
شيء	شيء,ليس,شاء
شيب	شاب,أشيب
شيخ	شيخ,شاخ
شيد	أشاد
شيط	شيطان,شيط,شاط,شيط
شيع	شيح,شيع,شاع,أشاع,شائعة,إشاعة,شيع
شيل	شال,شيول
صبب	صب
صبح	أصبح,صبح,صبح,مصابحة,مصباح,اصطبح,صبيح,صابح,استصبح,صباح
صبر	أصبر,صبر,صابر,صنبور,اصطبر,صبور,صبر,صنوبر,تصبر
صبع	إصبع
صبو	صبي,صبا
صحب	صاحبة,صاحب,صحب
صحح	صح,صحح,أصح,صحيح,صحة,صحح
صحف	صحيفة,صحف,مصحف,صحافة
صحن	صحن
صحو	صحى,صحوة,صحي,صحو,صحا
صدد	صد
صدر	تصدر,مصدور,مصدر,صدر,تصادر,صدر,صادر,استصدر
صدع	صدع,صداع,صدع
صدف	صادف,صدف,صدفة
صدق	صديقة,صدقة,أصدق,تصديق,تصدق,صدق,أصدقاء,صديق,صادق,صدق
صدم	اصطدم,صدام,مصدوم,صدم
صرح	صريح,أصرح,صرح,تصريح
صرخ	صاروخ,صرخ,صارخ
صرر	أصر,صرة,مصر
صرصر	صرصر
صرع	صرع,صارع
صرف	تصريف,انصرف,صراف,مصرف,صرف
صعب	أصعب,صعب
صعد	مصعد,صعد
صعق	صعق
صغر	أصغر,صغر,صغير
صغو	صغو,صغا,أصغى
صفح	صفحة,صفح,صفيحة
صفر	أصفر,اصفر,صفر,صفر
صفع	صفع,صفعة
صفف	صف
صفق	صفقة
صفو	أصفى,صفا,صفاء,صفي,صاف
صكك	صك
صلب	أصلب,صلب,صليب
صلح	صالح,أصلح,مصلحة,صلح,صلح
صلو	مصلى,صلى,صلاة,صلوة
صلي	أصلى,صلى,تصلى,اصطلى
صمت	صمت,صامت
صمد	صمد,صمود
صمغ	صمغ
صمم	صمم,صمم,أصم,تصميم,صمام
صنبر	صنوبر,صنبور
صندق	صندوق
صنع	صانع,صنع,أصنع,صنع,صناعة,مصنع
صنف	صنف
صنم	صنم
صوب	استصواب,صوب,أصاب,إصابة
صوت	صوت,صوت
صور	مصور,صور,تصوير,تصويرة,تصور,صورة,مصورة
صوغ	صيغة
صوف	صوف,تصوف,صوفي
صوم	صيام,صام
صون	صان
صوي	صوة
صيح	صاح
صيد	صيد,صياد,صاد,صيد,اصطاد
صير	صار
صيف	صيف
ضءن	ضائن,ضأن
ضبط	ضبط,مضبوط,ضابط
ضجع	ضاجع
ضحك	ضحك,ضحك,أضحك,مضحك
ضخخ	ضخ,مضخة
ضخم	تضخم
ضدد	ضاد
ضرب	اضطرب,ضريبة,ضربة,أضرب,ضرب,ضرب
ضرح	ضريح
ضرر	ضر,ضرر,ضرورة,مضر,اضطر
ضرس	ضرس
ضرط	ضرط
ضرع	مضارع,ضرع
ضرغط	اضرغط
ضعف	أضعف,ضعف,ضعيف
ضغط	ضغط
ضفدع	ضفدع
ضفر	ضفيرة
ضفف	ضفة
ضلع	ضلع
ضلل	ضل,ضلل,ضال
ضمم	انضم,ضم,ضمة
ضمن	تضامني,تضامن,ضمن,مضمون,ضمان,تضمن,ضمن,ضمني
ضهد	ضهد
ضوء	مضيء,أضاء,تضوأ,ضوء,استضاء,ضاء
ضيع	ضيع,ضاع,أضاع
ضيف	أضاف,ضيف,إضافة,ضاف
ضيق	ضاق,مضايق,ضيق,أضيق,مضايقة,ضايق,تضايق
طبب	طبي,تطبب,طبب,طبیب,طبيب,طب
طبخ	طباخ,طبخ,مطبخ
طبع	طابع,انطباع,طبيعة
طبق	طابق,طبقة,طبق
طحل	طحلب
طحلب	طحلب
طحن	طحينة,طحن,طحين,مطحنة,طحن
طرب	طرب,أطرب
طرح	انطرح,تطرح,تطارح,اطرح,طرح,طارح,طرح
طرد	طرد,استطرد,مطاردة
طرش	أطرش
طرط	طرطور
طرطر	طرطور
طرطع	طراطيع
طرف	طرف,تطرف,طرف,أطرف,متطرف,طريف
طرق	طريق
طرو	أطرى,طري
طري	أطرى,طري
طزج	أطزج
طعم	طعام,أطعم,مطعم,طعم
طعن	طعن
طغو	طاغوت
طغي	طغى,طاغوت
طفء	طفئ,طفأ,انطفأ,أطفأ
طفق	طفق
طفل	طفل,طفولة
طفو	طفا
طقس	
طلب	مطلوب,طالب,طلب
طلح	طلح
طلسم	مطلسم
طلع	طلع,أطلع,مطلع
طلق	أطلق,طلق,مطلق
طلل	طل,أطل
طلي	طلاء
طمع	طمع
طنن	طن
طهر	طهر
طور	تطور
طوع	طوع,طاوع,طاع,استطاع,أطاع,طوع,أطوع,قدرالمستطاع,تطوع
طوف	طاف
طوق	طاقة
طول	طال,طويل,طاول,طول,تطول,طاولة,تطاول,أطول,استطال,أطال
طيب	طيب,أطيب,شهيةطيبة,طاب
طير	طائر,طار,طيارة,طير,مطار,طييرة,طير,طائرة,أطير
طيف	طيف
طين	طين
ظبي	ظبي
ظرف	ظرفية,أظرف,ظريف,ظرف
ظلم	ظلمة,مظلم,أظلم,ظلم
ظنن	ظن
ظهر	ظاهرة,تظاهر,ظاهر,استظهر,ظهران,ظهر,ظهر,أظهر
عبء	عبء
عبد	عبد,عبد,تعبد,استعبد
عبر	عبر,معتبر,اعتبر,تعبير,عبري,اعتبار
عبس	عبس
عبعب	عبعب
عبل	عبل
عبم	عبم
عبن	عبن
عبهل	عبهل
عبو	عبوة,عبا,عبو
عتت	عتت
عتد	أعتد
عتعت	عتعت
عتق	عاتق,عتق
عتل	عتل
عتم	عتم
عتن	عتن,أعتن
عتو	عتو
عتي	حتى
عثث	عثث
عثج	عثج
عثجل	عثجل
عثر	عثر,عثر
عثعث	عثعث
عثق	عثق
عثكل	عثكل
عثل	عثل
عثلب	عثلب
عثم	عثم
عثن	عثن
عجب	عجب,أعجب,عجيب,عجاب,عجب,تعجب
عجج	عج,عجاج,عجج,عجج
عجر	عجر
عجرف	عجرفة,متعجرف,عجرف,تعجرف
عجرم	عجرم
عجز	عجز,عجز,عجوز
عجس	عجس
عجعج	عجعج
عجف	عجف
عجل	عجول,استعجل,عجيل,مستعجل,عجل,أعجل,عجل
عجم	أعجم,عجم,عجم
عجن	عجن,معجون
عجه	عجه
عجو	عجو
عدد	مستعد,متعدد,عديد,عدد,أعد,استعد,عدد,عد
عدر	عدر
عدس	عدس
عدف	عدف
عدق	عدق
عدل	تعديل,عادل,أعدل,تعادل,عدل,معدل,عدل
عدم	إعدام,معدوم,عدم
عدن	عدن
عدو	عدو,عدو,عدوى,اعتدى,تعدى,عدا,عدى,اعتداء
عذب	أعذب,تعذب,عذب,عذب
عذج	عذج
عذر	معذرة,اعتذر,عذراء,عذر,عذرة
عذف	عذف
عذفر	عذفر
عذق	عذق
عذل	عذل
عذلج	عذلج
عذلق	عذلق
عذم	عذم
عذو	عذو
عرب	استعرب,عرب,إعراب,عربية,أعرب,تعريب,عرب,تعرب
عربد	عربد
عربس	عربس
عربش	عربش
عربن	عربن,عربن
عرت	عرت
عرتن	عرتن
عرث	عرث
عرج	عرج,عرج,أعرج
عرد	عرد
عرر	عرر
عرز	عرز
عرس	عروس,عرس,عرس,عريس
عرش	عرش,عريش
عرص	عرص
عرض	عرض,عارض,معرض,عريض,استعرض,عرض,اعتراض
عرعر	عرعر
عرف	أعرف,معروف,عرف,استعرف,تعارف,عريف,عارف,عرف,اعترف,تعرف
عرق	تعرق,عرق,معرق,عرق,العراق,أعرق
عرقب	عرقب
عرقد	عرقد
عرقص	عرقص
عرقل	عرقل
عرقي	عرقي
عرك	عرك,عراك,معركة
عركس	عركس
عرم	عرم
عرمض	عرمض
عرن	عرين,عرن,أعرن
عرو	عرو
عري	عار,عري,عري,عراء,عريان
عزب	أعزب,تعزب,عزب
عزر	عزر
عزز	أعز,عز,عزز
عزف	عزف,معزف,عزف
عزل	تعزل,عزلة,أعزل,عزل,عزل
عزم	عزم,عزم,تعزم,اعتزم
عزو	عزا,عزو
عزي	عزى,عزي
عسب	عسب,عصبي
عسبل	عسبل
عسج	عسج
عسجر	عسجر
عسد	عسد
عسر	عسر
عسس	عسس
عسعس	عسعس
عسف	عسف
عسق	عسق
عسقل	عسقل
عسل	عسل,عسل
عسمط	عسمط
عشب	عشب
عشد	عشد
عشر	عشر,عشرة,عشر
عشش	عشش,أعش,عشش,عش
عشف	عشف
عشق	عاشق,عشق,تعشيقة,تعشق,عشق
عشو	عشاء
عشي	تعشى
عصب	عصب,معصب
عصر	عصر,أعصر,معاصر,عصير,تعصر,عصر
عصف	عصف,عصف
عصم	عاصمة,عصم,عصم
عصي	عصيان
عضض	عض,عضض,أعض
عضو	عضو,عضو
عطر	عطر,عطر
عطس	عطس,عطس
عطف	عاطف,عطف,أعطف,معطف
عطل	عطل,معطل,عطلة,عطل
عطو	عطو,أعطى,تعطى
عظم	عظم,أعظم,عظم,عظيم
عفج	تعفج,عفج,عفج
عفرت	عفريت
عفن	عفن,تعفن
عفو	عفوا,عافية
عقب	عقاب,عاقب,عاقبة,عقوبة
عقد	معقد,عقدة,عقد,انعقد,عقد,عقيدة,اعتقد,أعقد
عقر	عقر
عقل	اعتقل,اعتقال,معقل,معقول,أعقل,عقل,عقل,معتقل,عاقل
عقم	عقم,عقم,عقيم
عكس	عكس,عاكس,انعكس,عكس,تعاكس
علب	علبة
علج	عالج,معالجة
علق	تعليق,تعلق,علق,معلق
علم	معلم,تعالم,علم,تعليم,عالم,تعلم,معلوم,أعلم,عليم,علم,معلمة,استعلم
علن	أعلن
علو	تعالى,علا,عليا,علي,عال,علاوة,علوي,أعلى
علي	تعالى,علي,على,عال,أعلى
عمد	تعمید,عمد,عمد,تعمد,متعمد,عمود,عميد
عمر	اعتمر,عامر,عمر,معمار,عمر,أعمر,مستعمر,استعمر
عمق	أعمق
عمل	اعتمل,انعمل,استعمال,عمل,استعمل,عمل,تعامل,تعمل,عامل,أعمل
عمم	أعم,عام,عمومي,عامة,عامي
عمه	عمه
عمي	عمي,أعمى
عنف	عنيف,أعنف,عنف
عنو	عنوان
عني	معنى,عنى,عانى,اعتنى
عهد	متعهد,عهد,معهد
عهر	عاهرة,عهر
عهل	عاهل
عوج	اعوج
عود	عادة,أعاد,عود,اعتاد,عود,عاد,عادي
عوذ	استعاذ
عور	استعار,استعارات,أعار,عور,استعارة,عورة,عواري,معير,عوار,أعور,عور,عوارية
عول	عائلة
عوم	عام
عون	عاون,تعاون,استعان,أعان,عون
عيد	
عير	عار,تعاير,عير,معير,عير
عيش	عاش,عيش
عين	عيان,معين,معاينة,عاين,عين,عين
عيي	عيان
غبر	أغبر,غبر
غبن	غبن
غبو	غبي,أغبى
غبي	غبي,أغبى
غدر	غادر,غدير
غدو	تغدى,غداء
غذو	مغذ,تغذية,غذاء,غذى,غذا
غرب	مغرب,قرب,غرب,غربة,أغرب,غرب,غريب,اغترب
غرد	غرد,تغريدة,غرد,تغريد
غرر	غر
غرغر	غرغر
غرف	غرفة
غرق	غرق,غرق
غرم	أغرم,غرام
غزر	غزارة
غزل	غزل
غزو	غزو
غسل	غسالة,غسل,مغسلة,مغسل,غسل
غشي	غشاء,غشي
غصب	اغتصب,غصب
غصن	غصن
غضب	مغضوب,غضب,غضبان,غاضب
غضض	غض
غطس	غطس,مغطس
غطو	غطاء,غطى
غفر	غفر,غفير
غفل	غفل
غلب	غلب,غالبية,غالب,أغلب,غلبة
غلط	غلط
غلظ	أغلظ,غليظ
غلف	أغلف,غلفة,غلف,مغلف,غلف,غلاف
غلق	غلق,أغلق
غلل	غل
غلم	غلم,أغلم,غلام,اغتلم
غلو	أغلى,غال
غلي	غلى,غلاية,غليون
غمر	غمر
غمض	غموض,أغمض
غمم	غمامة
غني	غني,أغنى,أغنية,غنى,غناء
غور	غور,غارة
غوص	غوص
غول	اغتيال,اغتال,غول
غوي	غاية
غيب	غائب,غيب,غاب,تغيب,غيبة,غابة
غيد	غيد
غير	أغير,غيور,تغير,غيرة,غار,غير,غير,غائر
غيظ	غيظ
غيم	غيمة,غائم
فءس	فأس
فتح	فتاحة,مفتوح,فاتحة,أفتح,فاتح,فتح,افتتاحي,افتتح,تفتح,فتاح,افتتاح,فتح
فتر	فتور
فتش	فتش,مفتش
فتن	فتنة
فتو	فتوى,مفت,فتى,فتاة
فتي	فتى,فتاة
فجء	مفاجأة,فجأة,تفاجأ,فجء,فجائي,فاجأ
فجج	فج
فجر	أفجر,فاجرة,انفجر,تفجر,فجر
فجو	فجوة
فحش	فاحشة,فحشاء,فحش,فحش
فحم	فحم
فخذ	فخذ
فخر	فخور,فخر,أفخر,فاخر
فخم	أفخم,فخم
فدي	فدى,فدية,فداء
فرج	فرج
فرح	فرحان,فرح,فرحة,فرح
فرخ	فرخ
فرد	منفرد,فريد,فرد,انفرد
فرس	تفرس,فارس,فرس,فروسية,فريسة,افترس,فرس
فرش	فرش,فراش
فرص	فرصة
فرض	افترض,فرض,فرض
فرع	أفرع,فارع,فرع
فرغ	استفرغ,فروغ,إفراغ,تفرغ,فرغة,استفراغ,فرغ,فارغ,متفرغ,تفريغ,مفروغ,مستفرغ,فراغ,مفرغ,أفرغ,فرغ
فرق	فرق,فريق,تفرق,فارق,تفارق,فرقة
فزز	استفز,فز,فزز
فزع	فزع
فسح	فسح
فسد	أفسد,فاسد
فسر	فسر,تفسير
فسفس	فسفس
فسق	فسق,فسقية,فسق
فسل	فسل,أفسل
فسو	فسا
فشل	فشل,فشل
فشو	فشو
فصح	فصح,أفصح
فصل	فصيلة,منفصل,فصل,انفصل,فصل
فضح	فضيحة,فضح
فضض	فضض,فضة,فضي
فضل	مفضل,تفاضل,فضل,تفضل,أفضل,فضل
فضو	فضاء
فضي	فضاء
فطر	تفطر,انفطر,فطر,إفطار,أفطر,فاطر
فعل	تفاعل,أفعل,فعل,فعل,فاعل,افتعل,انفعل
فعو	أفعى
فعي	أفعى
فغي	أفعى
فقد	تفقد,مفقود,فقد,فقد
فقر	افتقر,فقر,فقرة,فقر,أفقر,فقير
فقس	فقس
فقم	تفاقم
فقه	فقيه,فقه
فكر	فكر,تفكر,فكر
فلح	أفلح,فلاح
فلس	أفلس,إفلاس
فلك	فلك
فني	فان,أفنى
فهم	استفهم,فهم,تفاهم
فوت	فوت,فات
فور	فوار,فور,فوارة,فور,فار,فورا
فوز	مفازة,فوز,فائز,فاز,فوز
فوض	تفاوض,فوضى,فوضوي,فوضوية
فوق	أفاق,تفوق,متفوق,فوق
فيد	استفاد,فائدة,أفاد,مفيد
فيض	أفاض,فاض
قبب	قيقب
قبح	أقبح,قبح,قبيح,استقبح
قبر	قبر,أقبر,قبر,مقبرة
قبص	قبص
قبض	قبض,تقبض,قبض
قبط	قبط
قبع	قبع
قبقب	قبقب
قبل	مقابلة,قابلة,قابلية,تقابل,قبلة,استقبل,تقبل,قبلا,قبيلة,أقبل,قابل,قبل,اقتبل,قبل
قبن	قبن
قتب	قتب
قتد	قتد
قتر	قتر
قتع	قتع
قتل	تقاتل,قاتل,قتل,قتل,أقتل,اقتتل,مقتل,استقتل
قتم	قتم
قتن	قتن
قثث	قثث
قثقث	قثقث
قثم	قثم
قثو	قثو
قحب	قحبة,قحب
قحث	قحث
قحثر	قحثر
قحح	قحح
قحد	قحد
قحز	قحز
قحزل	قحزل
قحزن	قحزن
قحش	قحش
قحص	قحص
قحط	قحط,قحط
قحطب	قحطب
قحف	قحف
قحقح	قحقح
قحل	قحل
قحم	قحم
قحو	قحو
قدح	قدح,قدح,قداحة
قدد	قدد,قد,مقداد,تقدد,انقد
قدر	أقدر,قدر,تقدير,قدر,قدرة,مقدرة,قدير,مقدار,تقدر,قادر
قدس	قديس,أقدس,قدس,مقدس,قدس,القدس,تقدس
قدع	قدع
قدف	قدف
قدم	قدم,أقدم,قادم,قدم,تقدم,متقدم,مقدم,قديم
قدو	قدو
قدي	قدي
قذذ	قذذ
قذر	قذر,قذر
قذع	قذع
قذف	قذيفة,قذف,قذف
قذقذ	قذقذ
قذي	قذي
قرء	قرء,قراءة,تقرأ,القرآن,أقرأ,قرأ,استقرأ,انقرأ
قرب	قرب,قارب,مقراب,أقرب,غرب,قرب,قربة,اقترب,قريب
قرح	قرحة,اقترح,قرح
قرد	قرد,قرد,قراد
قردح	قردح
قردس	قردس
قرر	قار,قرر,قرارة,قرة,قر,تقرر,مقرر,أقر,مستقر,استقر,قرر,مقر,قارة,قرير
قرز	قرز
قرزل	قرزل
قرزم	قرزم
قرس	قرس
قرش	قرش,قرش
قرشح	قرشح
قرص	قرص,قرصة,قرص
قرصب	قرصب
قرصم	قرصم
قرصن	قرصن,قرصنة,قرصان,قرصن
قرض	انقرض,استقرض,قارض,قرض,قرض,اقترض,أقرض,تقارض
قرع	قرع,قرعة
قرن	قرين,قارن,قرن
قري	قرية
قسط	قسط,قسط
قسم	قسمة,قاسم,قسم,تقسيم
قسو	قسو,قسوة
قشر	قشر
قشعر	اقشعر
قصب	قصب,قصاب,قصيبة
قصد	قصد,اقتصد,مقصود,قصيدة,اقتصاد,قصد
قصر	أقصر,قصير,مقصر,قصر
قصص	قصة,قص,مقص
قصف	قصف
قصو	أقصى
قضب	اقتضب,مقتضب,قضب,قضيب
قضي	أنقض,تنقض,نقض,انقضى,اقتضى,قاض,قضي,قضى,قضية
قطب	استقطب,قطب,قطب,تقطب
قطر	استقطر,قطار,قطر,تقاطر,تقطر
قطط	مقط,أقط
قطع	قاطع,مقطوع,قطع,انقطع,قطعة,مقاطعة,تقاطع
قطف	قطف,قطيفة,القطيف,اقتطف,قطف
قطم	قطمة
قطن	قطن
قعد	القاعدة,تقاعد,قاعدة,مقعد,قعد
قعر	قعر,قعر
قفر	قفر,قفر
قفز	قفز
قفقف	قفقف
قفل	أقفل,قفل,قافلة,مقفول
قلب	انقلب,قليب
قلد	قلد
قلق	قلق
قلل	قلل,أقل,قليل,قلة,استقلال,استقل,قل,مستقل
قلم	قلم
قلي	قلى
قمح	قمح
قمر	قامر,قمر,قمرة
قمش	قماش
قمع	قمع,قمع
قمم	قمة
قنطر	قنطر,قنطار,قنطر,قنطرة
قنع	اقتنع,قنع,أقنع
قهر	قهر
قهقه	قهقه
قهو	مقهى
قود	قائد,قاد,انقاد
قوس	قوس
قوع	قاع,قاعة
قول	قول,قول,مقال,تقول,قال,مقالة,مقولة
قوم	أقام,إقامة,مستقيم,قائمة,قومي,مقام,قاوم,قوم,قوم,قام,استقام
قوي	قوى,أقوى,قوي,قوي
قيء	قياء,قاء,تقيأ
قيد	قيد
قيس	مقاس,قاس,مقايسة,قايس,قياس
قيف	قيافة
قيل	إقالة,أقال,قال,استقال
قين	قين
كءس	كأس
كبب	كباب
كبد	كبد
كبر	أكبر,كبرياء,تكبر,كبر,كبير,كبر,كبري
كبس	كبيس,كبس,كابوس
كتب	أكتب,اكتتاب,مكاتب,تكتيب,مكتبة,مكتب,كتابة,اكتتب,كاتب,كتب,استكتاب,كتب,استكتب,تكاتب,كتاب,كتبي,كتيب,مكتوب,إكتاب,انكتب
كتل	تكتيل,كتل,كتلة,كتل,تكتل
كثب	كثيب
كثر	كثيرا,استكثر,كوثر,كثر,كثير,كثر,أكثر,كاثر,تكاثر
كحل	اكتحل,كحل,تكحل,كحل
كدس	تكدس,مكدوس,مكدس,تكديس,كادس,متكدس,كدس
كذب	تكذب,كذب,كذب,كذاب
كرب	كرب,كرب,انكرب,اكترب,أكرب
كرث	كارثة,كرث
كرر	كرر,كرر
كرس	كرسي
كرم	كرم,كريم,كرم,أكرم,مكرم
كره	كره,أكره,كراهية,استكره,كره,تكره
كري	كراء
كسب	كاسب,كسب
كسح	أكسح
كسر	كسر,مكسور,انكسر,كسر,كسارة
كسل	كسل,كسل,كسلان
كسو	كساء
كشف	انكشف,اكتشف,كشف,كشف,استكشف
كظم	
كعب	كعب,كعبة
كعك	كعكة,كعك
كفء	كافأ,كفاءة,تكافأ
كفر	كفر,تكفير,أكفر,كفارة,كفر,تكفيري,كافر
كفف	انكف,استكف,كف,كافة,كفف
كفل	كفل,كفل
كفهر	اكفهر
كفي	اكتفى,كفى,كاف
كلب	أكلب,كلب,استكلب
كلف	مكلف,كلف
كلل	كليل
كلم	كلام,تكلم,متكلم,كالم,كلمة,كلم,كلم
كمل	كمل,كميل,كمل,كمال,كامل,أكمل,مكمل
كمن	كمون
كنس	مكنسة,كنيسة
كهرب	كهرب
كهن	كاهنة,كاهن
كوت	تكويت,كوت,الكويت
كون	مكون,مكان,كيان,كون,كون,مكانة,كان,تكون
كوي	مكواة,مكوى
كيف	كيف
كيل	كيول
لءك	ملائك,ملأك,ملائكة
لءلء	لؤلؤة,لألأ,لؤلؤ,لءلء,لؤلؤي
لءم	تلاؤم,ملائم
لبب	لبب
لبث	لبث
لبس	لبس,لباس,ملبس,لبس
لتت	اللات
لجء	لجأ,لاجئ,لجء,لجوء,لجئ,ملجأ
لجج	لج
لجن	لجنة
لحد	لحد
لحس	لحس
لحظ	لحظ,ملاحظة,لاحظ,لحظ,ملاحظ
لحف	لحاف
لحق	لحق,ألحق,ملاحقة,لاحق
لحن	ملحون,تلحين,ملحن,لحن,لحن
لخص	لخص
لذذ	ألذ
لزم	التزم,التزام,لازم,ألزم
لسن	لسان
لصص	لص
لطف	لطف,لطف,لطيف
لعب	لعب,لاعب,لعاب,ملعب,تلعب,لعبة
لعق	ملعقة,لعق
لعن	لعن
لغو	لغوي,لغو,إلغاء,لغة
لفت	التفت,لفت
لفظ	تلفظ,لفظ
لفف	لفافة,ملف,لفاف
لفو	ألفى
لقب	لقب
لقح	حبوباللقاح,لقاح
لقط	التقط
لقف	لقف
لقم	لقمة
لقن	لقن,لقن
لقي	ملاقاة,التقى,تلاقى,لقيت,تلقى,لاقى,استلقى,ألقى,لقي,لقاء,لقي
لكن	لكن
لمز	لمز
لمس	لامس,تلامس,التمس,لمس,لمس
لهج	لهجة
لهم	لهم,استلهم,تلهم,لهم,التهم,ألهم
لوث	تلوث,لوث
لوح	لاح,لوح,لوحة,لائحة
لوم	لام
لون	تلون
لوي	لواء
ليس	أليس
ليق	أليق,ليقة,لاق,لائق
ليل	ليل,ليلة
لين	ألين,لين
مءن	مينا,ميناء
متع	متعة,استمتع,تمتع,متاع,ممتع
مثل	تمثال,مثل,ماثل,ممثل,امتثل,مثل,مثيل,مثال,ممثلة,مثالي,تمثل,تماثل,أمثل
مثن	مثن
مجد	مجد,ماجد,مجيد,أمجد
مجر	مجر
محص	محص
محق	ممحوق,محق,ماحق
محن	محن,امتحان,امتحن
محو	محا
مدد	مادة,أمد,مدة,مد,امتد
مدن	مدينة,مدن,تمدن
مدي	مدى,مدية
مذي	مذي
مرء	امرؤ,امرأة
مرج	مرج
مرد	مارد,مرد,تمرد
مرر	مار,أمر,استمرار,مستمر,مر,مرة,ممر,مرر,مرير,استمر,مرارة
مرس	مارس
مرش	مرش
مرض	ممرض,مرض,مرض,مريض,أمرض
مرن	مرن,تمرين
مزج	مازج
مزح	مازح,مزح
مسح	مسيح,مسح,ممسوح,ممسحة,ماسح,تمسيح,ممسح,مساحة
مسد	مسد
مسس	مس,ماس
مسك	أمسك,تماسك,تمسك,مسك,مسك,استمسك
مسو	مساء
مشي	ماشية,مشية,مشى,مشي,ماش
مصص	مص
مضغ	مضغ
مضي	أمضى,مضى,ماض
مطر	ممطر,مطر,أمطر,مطر,استمطر,ماطر,ممطرة
مطط	مطاط
معز	ماعزة,ماعز,معز,معزة
معض	امتعض,امتعاض
معي	معى
مكث	مكث
مكر	مكر
مكس	مكس
مكن	تمكن,أمكن,ممكن,مكن
ملء	مملوء,ملأ,ممتلئ,ملء,أملأ,ملآن
ملح	أملح,مليح
ملك	مملوك,مملكة,أملك,مالك,امتلك
ملل	ممل,أمل
منء	مينا,ميناء
منع	امتنع,منع,ممنوع
منو	مني,استمنى,تمنى
مني	مني,استمنى,تمنى
مهر	ماهر,أمهر
مهل	مهلة
مهن	مهنة
موت	استمات,موت,ميت,مات,موت,أمات
موج	موج
مول	مال,مول
موه	ماء
ميد	ميد
ميز	متميز,أميز,ممتاز,امتاز
ميس	ميس
ميل	أميل,مال,ميل,ميل
نءي	نأى
نبء	نبء,أنبأ,تنبأ,استنبأ,نبي
نبت	نبات,نبت
نبح	نبح,نبح
نبخ	نبخ,نبخ
نبذ	نبذ,نبذ,أنبذ,نبيذ
نبر	نبر,نبر
نبز	نبز
نبع	منبع
نبه	انتبه
نبو	نبي
نتج	نتيجة,منتج
نتن	نتن,نتن
نجح	نجاح,نجح
نجد	أنجد,نجدي,استنجد,نجدة,نجد,نجد,ناجد,نجادة
نجر	نجار
نجز	أنجز
نجس	نجس,نجس
نجل	نجل
نجم	تنجم,نجام,نجم,منجم,نجمة
نجو	نجا
نحت	نحت
نحر	نحر,نحر,انتحر
نحف	أنحف,نحيف,نحف
نحل	نحل,تنحل,نحل,أنحل,انتحل
نحو	نحو,تنحى,ناحية
نخب	انتخاب
نخع	نخاع
نخي	نخي
ندب	ندب
ندد	ندد,ندد
ندر	أندر,نادر
ندم	ندم
ندو	ناد,نادى,ندو,ندي,منتدى
نذر	نذر
نزع	نزع
نزف	نزف
نزق	
نزل	نزل,نزل,أنزل,تنزل,منزل
نسء	نسيئة,نسأ,نسء,منسأة,نساء
نسب	انتسب,تناسب,مناسبة,استنسب,ناسب,نسب,مناسب,نساب,نسبة
نسخ	نسخ
نسف	نسف
نسق	نسق,نسق
نسل	نسل
نسو	نساء
نسي	نسي,نسى,نسي
نشء	أنشأ,نشئه,نشأ,نشء,إنشاء
نشب	نشب
نشر	نشرة,نشر,نشر,انتشر,منشار
نشط	أنشطة,نشاط,نشيط,تنشط,أنشط,نشط
نشف	نشافة,منشفة
نشل	نشل
نشو	نشاء
نصب	منصب,نصب
نصت	تنصت,نصت,أنصت
نصح	أنصح,نصح,نصيحة,نصح
نصر	نصر,انتصار,انتصر
نصص	نص
نصف	نصف,أنصف,منصف
نضد	نضد
نطط	نط
نطف	نطف
نطق	منطقة,منطق,نطق,نطق
نطنط	نطنيطة,نطيطة
نظر	ناظر,منظر,نظارة,انتظر,نظر,نظرية,نظير,نظر
نظف	نظيف,نظف,أنظف
نظم	انتظام,منتظم,نظام,نظم,انتظم,تنظيم,نظم,منظمة
نعس	نعسان
نعظ	نعظ,نعظ,أنعظ,نعوظ,ناعوظ
نعل	نعل
نعم	نعام,أنعم,نعامة,نعيم,ناعم,نعم,इनाम
نعنع	نعنع
نفخ	انتفخ
نفد	نفد,استنفاد
نفذ	نفذ,نفاذ,نفذ,نفوذ,نافذة
نفر	تنافر,نفر,نافر
نفس	نافس,تنافسي,نفيس,نفس,تنفس,أنفس
نفض	انتفض
نفع	أنفع,نافع,نفع
نفق	نفق,نفق
نفو	نفا
نفي	نفى,نفي
نقب	نقيب,نقاب
نقد	انتقاد,نقد
نقذ	أنقذ
نقز	نقز
نقش	ناقش,مناقشة
نقص	نقص,ناقص
نقض	نقض,تناقض,أنقض,تنقض,متنقض,مناقض,منتقض,انتقاض,إنقاض,نقض,انتقض,ناقض,منقض,نقيض
نقط	نقطة
نقل	منقول,نقل
نقم	نقم,انتقم
نقو	نقي,أنقى
نقي	نقي,أنقى
نكب	نكبة
نكح	نكح,نكح
نكر	استنكر,نكر,نكر
نكس	نكس
نكص	نكص
نكف	نكف
نمق	نمق,نمق
نمم	نم
نمو	نما,نمو
نمي	نمى
نهب	نهب
نهج	نهج
نهر	نهر
نهض	نهضة,نهض,ناهض
نهق	نهق
نهك	انتهك,انتهاك
نهي	نهي,نهاية,انتهى,أنهى
نوب	نائب,أناب
نوخ	مناخ
نور	أنار,تنور,منارة,أنور,نار,استنار,نير,منار,نور
نوش	نوش
نوع	نوع,تنوع,متنوع
نوق	ناقة
نول	ناول
نوم	نوم,نام,منوم,نوم,تناوم,أنام
نوه	نوه
نوي	نواة,انتوى,نوى,ناوى
نيك	نيك
نيل	نال
هبب	هب,هبوب,هبب
هبط	هبط
هبو	هباء
هتف	هاتف
هجر	هجران,هاجر
هجم	هاجم,مهاجم,هجم,هجوم
هدء	أهدأ,هدوء,هادئ
هدج	هودج
هدد	هدد
هدف	أهدف,تهدف,هدف,هدف,استهدف
هدم	هدم
هدن	هدنة
هدي	هدي,مهدي,هدى,هدية
هذي	هذيان,هذى
هرب	هرب,تهرب
هرم	هرم
هزء	استهزأ
هزز	هز,اهتز,هزز
هزم	هزيمة,هزم,هزم,انهزم
هلك	هلك,استهلك
همز	همزة,همز
همل	أهمل,مهمل
همم	مهم,اهتم,هم,أهم,مهتم,هام
هنء	بالهناءوالشفاء,هنأ
هندس	مهندس,هندس,هندس
هندم	هندام,هدم
هود	هاد,هود
هول	هول,هائل,هال
هون	أهان
هوي	هواء,هواية,هوي
هيء	هيئة,تهيأ,هاء,هيء
هيب	هاب
هيف	أهيف,هيف
وءي	وأى
وتر	توتر,واتر,وتر
وثق	وثق,وثق,وثيقة,واثق
وجب	واجب,وجب,أوجب,وجبة,وجب
وجد	تواجد,وجد,موجود,وجد,إيجاد,توجد,أوجد,نجد
وجز	وجيز
وجس	وجس
وجع	وجع
وجل	وجل
وجه	واجه,أوجه,وجه,وجيه,تجاه,إتجاه
وحد	وحد,متوحد,وحدانية,اتحد,توحد,متحد,وحيد,أحد,وحد,وحداني,أوحد,اتحاد
وحش	أوحش
ودد	ود
ودع	ودع,أودع
ودي	أودى,واد
ورء	وراء
ورث	ورث,أورث,وارث,ورث
ورد	ورد,ورد,استورد
ورط	أورط,استورط,ورط,تورط,ورطة,ورط
ورع	تورع,ورع
ورق	ورق
ورك	ورك
وري	أورى,وراء
وزر	وزير
وزع	توزع
وزن	توازن,وزن
وزي	وازى,توازى
وسخ	اتسخ,أوسخ,وسخ
وسد	وسادة
وسط	أوسط,وسط,متوسط,واسطة
وسع	موسوعة,أوسع,وسع,واسع
وسق	وسق
وسل	وسيلة
وسم	سمة,موسم,وسيم,وسام,أوسم,وسم
وسوس	وسوس
وصب	وصب
وصف	وصفة,وصف,صفة,مستوصف
وصل	تواصل,متصل,اتصل,وصل,وصلة,واصل,توصل,أوصل,صلة,وصل
وصي	وصاية,وصي,تواصى,وصية,أوصى,وصى
وضح	توضح,واضح,وضاح,استوضح,وضح,أوضح,اتضح,وضح
وضع	تواضع,متواضع,موضع,وضعة,موضوع,وضع
وطء	وطء,وطيء,وطئ,تواطؤ,أوطأ,تواطأ
وطن	وطني,وطن,وطنية,مواطن,وطن,موطن,استوطن
وظف	توظيف,وظف,وظيفة
وعث	وعثاء
وعد	توعد,واعد,وعد,تواعد,ميعاد,اتعد,وعد,أوعد
وعظ	وعظ,واعظ
وعي	وعاء,توعوي,وعي,توعية,وعي,وعى
وغر	وغر
وفر	وفير,وفرة,وافر,أوفر,وفر
وفق	أوفق,توفيق,اتفق,وافق,اتفاق,موافق,وفق,توافق
وفي	أوفى,وفاة,توفي,توفى,وافى,وفي,وفى,استوفى
وقب	وقب
وقت	وقت
وقد	موقد
وقع	وقع,واقعة,توقع,واقع,موقع,توقيع
وقف	أوقف,توقيف,وقف,تواقف,وقف,موقف,توقف,استوقف
وقي	وقى,متقون,يقين,توقى,اتقى
وكء	اتكأ,توكأ
وكب	موكب
وكد	توكد,وكد
وكز	وكز
وكل	وكالة,توكل,وكيل
ولد	تولد,والد,ولد,ولد,أولد,والدة
ولع	ولاعة
ولي	وال,تولى,مولى,استولى,أولى,والى,ولاية,ولى,ولي,ولي,توالى
ومء	إيماء,أومأ
ومس	مومسة,مومس
وهب	وهب
وهن	وهن
يءس	يئس,يأس
يدد	
يرق	يرقة
يسر	يسر,يسار,أيسر,تيسر,يسير,يسر
يقظ	يقظ,استيقظ,تيقظ,يقظ,أيقظ
يقن	أيقن
يمن	ميمنة,ميمون,أيمن,اليمن
يوم	يوم
