احتل	حلل
خفض	خفض
قحح	قحح
تعالى	علو
طرد	طرد
شكر	شكر
صيد	صيد
اجلعد	جلعد
آخذ	ءخذ
أين	ءين
وعد	وعد
تنوع	نوع
رادد	ردد
عريان	عري
انطفأ	طفء
ماشية	مشي
دعا	دعو
حشرة	حشر
نسأ	نسء
حيوان	حيو
تأكيل	ءكل
خارج	خرج
حركة	حرك
بشري	بشر
شرفة	شرف
ساحر	سحر
مجموعة	جمع
تباءس	بءس
قحل	قحل
عقيدة	عقد
أولد	ولد
أشخص	شخص
قرب	قرب
منشار	نشر
حرك	حرك
يئس	يءس
تفاقم	فقم
ندب	ندب
اختلف	خلف
اجرمز	جرمز
حسب	حسب
صفع	صفع
عمد	عمد
نكح	نكح
حرباء	حرب
مؤامر	ءمر
هاء	هيء
استحمل	حمل
اغتلم	غلم
نحيف	نحف
زكاة	زكو
قصد	قصد
أوسم	وسم
حرك	حرك
دني	دنو
وعظ	وعظ
شاق	شوق
عسج	عسج
مبعوث	بعث
أل	ءلل
تعذب	عذب
زيغ	زيغ
استثناء	ثني
قمة	قمم
عجج	عجج
معتبر	عبر
مترب	ربو
وأى	وءي
حاقق	حقق
علم	علم
شراع	شرع
ثانوي	ثني
حواط	حوط
خريج	خرج
شمال	شمل
مثنى	ثني
وكز	وكز
مقاس	قيس
تداعى	دعو
سخر	سخر
أعمل	عمل
هدى	هدي
شال	شيل
مأمور	ءمر
آب	ءوب
واجب	وجب
استأنى	ءني
سلبي	سلب
انكرب	كرب
مجاورة	جور
أجرأ	جرء
حاوط	حوط
فصل	فصل
متطرف	طرف
شرع	شرع
تقدر	قدر
جادل	جدل
شزر	شزر
صامت	صمت
غذاء	غذو
إحفاظ	حضر
زخة	زخخ
جذر	جذر
ساكت	سكت
مخرج	خرج
أم	ءمم
روى	روي
شيط	شيط
غيبة	غيب
تأكل	ءكل
خفي	خفي
والى	ولي
أقبر	قبر
بالهناءوالشفاء	شفي
رزق	رزق
لغوي	لغو
خرج	خرج
قرص	قرص
عامة	عمم
مخلص	خلص
جرف	جرف
مشهد	شهد
صفة	وصف
أكتب	كتب
أخلص	خلص
سمع	سمع
سكن	سكن
يسر	يسر
اصطلى	صلي
اشتباہی	شبه
صنع	صنع
كبر	كبر
أهيف	هيف
تفضل	فضل
أسمع	سمع
خبء	خبء
بلغ	بلغ
فضاء	فضي
عتت	عتت
ناد	ندو
ميناء	مءن
أهمل	همل
استحقاق	حقق
احول	حول
زحم	زحم
سلطوي	سلط
ريح	ريح
انتهى	نهي
مقرر	قرر
أعتد	عتد
صف	صفف
منتدى	ندو
مار	مرر
حظر	حظر
ساحرة	سحر
حقا	حقق
قذذ	قذذ
حنف	حنف
دير	دير
أساء	سوء
استمرار	مرر
غاية	غوي
نفا	نفو
تضامني	ضمن
خوان	خون
أوفى	وفي
عمي	عمي
رمح	رمح
أتعس	تعس
أله	ءله
توافق	وفق
رمى	رمي
طمع	طمع
أطير	طير
أذى	ءذي
حس	حسس
تجميع	جمع
فداء	فدي
قل	قلل
استأجر	ءجر
قبط	قبط
عير	عير
مرتاح	روح
ملآن	ملء
عصم	عصم
أعجل	عجل
حبر	حبر
فضيحة	فضح
لهم	لهم
فان	فني
عادل	عدل
دني	دني
ذكري	ذكر
محا	محو
اللات	لتت
تباحث	بحث
ملائم	لءم
عشد	عشد
تل	تلل
تعرف	عرف
اصطاد	صيد
أطيب	طيب
تسوق	سوق
عرك	عرك
غبي	غبو
صحح	صحح
ختن	ختن
محتوى	حوي
مسل	سلو
معنى	عني
موسوعة	وسع
صغو	صغو
إبزيم	بزم
غدير	غدر
ناعوظ	نعظ
مثل	مثل
أكسح	كسح
اثنان	ثني
غناء	غني
عزر	عزر
عزف	عزف
أهم	همم
مسدس	سدس
نهق	نهق
استصبح	صبح
توفي	وفي
حسد	حسد
لجنة	لجن
وراء	وري
حبس	حبس
أدكن	دكن
ضلل	ضلل
مرقص	رقص
استمسك	مسك
فرع	فرع
عتق	عتق
صلاة	صلو
استراح	روح
صغر	صغر
زحل	زحل
ضيق	ضيق
حماة	حمو
عصف	عصف
نجم	نجم
حادثة	حدث
إمارة	ءمر
لقمة	لقم
غول	غول
إحاطة	حوط
تأمير	ءمر
تعريب	عرب
كلب	كلب
توالى	ولي
حشيش	حشش
أعمى	عمي
سلام	سلم
بلد	بلد
مأوى	ءوي
تشاجر	شجر
مدهش	دهش
نجدة	نجد
تراجع	رجع
اتفاق	وفق
عرقد	عرقد
ركعة	ركع
بسم	بسم
احتاط	حوط
حرص	حرص
تداخل	دخل
إحماد	حمد
أركس	ركس
صلة	وصل
متوحد	وحد
قبلة	قبل
اسلنطح	سلطح
تنفس	نفس
جمد	جمد
مقطوع	قطع
مني	مني
دع	دعع
غفر	غفر
غارة	غور
نشاء	نشو
غبي	غبي
رفق	رفق
ثبط	ثبط
واد	ودي
زائف	زيف
أدنى	دني
احرنشف	حرشف
تطور	طور
بكلة	بكل
فرش	فرش
جمع	جمع
أبدا	ءبد
علا	علو
فضل	فضل
طفأ	طفء
ملجأ	لجء
وافى	وفي
اشتمل	شمل
حسب	حسب
فضاء	فضو
خلاق	خلق
قسو	قسو
فاجأ	فجء
أطفأ	طفء
بصر	بصر
نفيس	نفس
سبب	سبب
أسلس	سلس
مستقل	قلل
مؤاتاة	ءتي
تقبل	قبل
بطيء	بطء
مجاهدة	جهد
ضهد	ضهد
شريف	شرف
طاوع	طوع
حدثان	حدث
معزة	معز
خفيف	خفف
دخن	دخن
أطلع	طلع
بدر	بدر
حلقوم	حلق
نكح	نكح
لامبالاة	بلو
استخدم	خدم
دفن	دفن
تزنر	زنر
سيادة	سود
نعل	نعل
عنى	عني
تحامل	حمل
ءسو	ءسو
اختتن	ختن
أندر	ندر
أبهج	بهج
أذن	ءذن
أشار	شور
مدرك	درك
زان	زني
تقاتل	قتل
أوب	ءوب
سعد	سعد
اجتهاد	جهد
مبالغة	بلغ
كتلة	كتل
استدل	دلل
فرض	فرض
غضبان	غضب
تلاقى	لقي
ابرغش	برغش
مضايق	ضيق
احرنجم	حرجم
استاء	سوء
مدارس	درس
مؤوب	ءوب
مؤاكل	ءكل
صديقة	صدق
مسمار	سمر
سفد	سفد
شفق	شفق
وصلة	وصل
شرط	شرط
دور	دور
شاش	شوش
عفريت	عفرت
تعبير	عبر
أشوس	شوس
طراطيع	طرطع
حارب	حرب
توعد	وعد
أصرح	صرح
دورة	دور
سديم	سدم
قعر	قعر
اخضل	خضل
صوت	صوت
أنجد	نجد
علي	علو
كافة	كفف
مستعجل	عجل
استعد	عدد
اجتهد	جهد
عركس	عركس
حدث	حدث
ضرب	ضرب
مرة	مرر
استقبل	قبل
حضض	حضض
تحسب	حسب
مثير	ثور
أجل	جلل
مؤذن	ءذن
لبب	لبب
خرق	خرق
عسجر	عسجر
انشغف	شغف
تفوق	فوق
أثاث	ءثث
خاطب	خطب
محق	محق
قصف	قصف
أفعى	فغي
دبابة	دبب
عسبل	عسبل
خاتم	ختم
استثنى	ثني
استراحت	روح
انكشف	كشف
حالم	حلم
صداع	صدع
تشكر	شكر
صاحبة	صحب
عشق	عشق
رحل	رحل
تسرى	سري
رقيق	رقق
ميد	ميد
وصي	وصي
عسس	عسس
كثر	كثر
نجادة	نجد
اجتماعي	جمع
مكواة	كوي
مكانة	كون
أزهد	زهد
توحد	وحد
إعراب	عرب
أرهب	رهب
كعكة	كعك
اشتهار	شهر
اختمار	خمر
نيك	نيك
اقترح	قرح
رابطة	ربط
شديد	شدد
حوالي	حول
تكافأ	كفء
لحن	لحن
خيرة	خير
اضطرب	ضرب
نبت	نبت
راجع	رجع
تزلزل	زلزل
قول	قول
اخضلال	خضل
عضو	عضو
سور	سور
لاق	ليق
غالبية	غلب
معلق	علق
تبع	تبع
معين	عين
عسد	عسد
محب	حبب
مكدوس	كدس
تخدر	خدر
نبر	نبر
اثنى	ثني
مترجم	ترجم
تآكل	ءكل
يسير	يسر
مسك	مسك
عدد	عدد
نافس	نفس
دوار	دور
عريس	عرس
أساس	ءسس
نجس	نجس
محام	حمي
أخ	ءخو
غار	غير
منع	منع
قذر	قذر
ذرة	ذري
مشية	مشي
أغلب	غلب
أضيق	ضيق
استحب	حبب
زائر	زور
ذهن	ذهن
رزز	رزز
جامل	جمل
تصوير	صور
قضي	قضي
خبط	خبط
مدفع	دفع
شبح	شبح
قطن	قطن
صاروخ	صرخ
زبل	زبل
مهنة	مهن
دفأ	دفء
أوصى	وصي
كتابةالرسائل	رسل
مسود	سود
هلك	هلك
تحبب	حبب
فرغة	فرغ
توعوي	وعي
استثمر	ثمر
مملوك	ملك
انتقم	نقم
ذيل	ذيل
ايتمار	ءمر
خبأ	خبء
حقد	حقد
تردى	ردي
ثان	ثني
شريط	شرط
شفه	شفه
أرخى	رخي
قرصان	قرصن
نتيجة	نتج
حكم	حكم
جامعة	جمع
نافر	نفر
رجا	رجو
نطق	نطق
احترم	حرم
فتنة	فتن
أقصر	قصر
استولى	ولي
شك	شكك
تعرب	عرب
عشف	عشف
تقدد	قدد
نادر	ندر
ألم	ءلم
فعل	فعل
مكث	مكث
تحديث	حدث
مكاتب	كتب
طفل	طفل
مسيرة	سير
حاضر	حضر
نائب	نوب
نشط	نشط
hazaña	حسن
فرغ	فرغ
أبعد	بعد
زر	زرر
ابتز	بزز
أسود	سود
استورد	ورد
نص	نصص
أوطأ	وطء
خائن	خون
رجف	رجف
آجر	ءجر
وعاء	وعي
أشعر	شعر
قائد	قود
عنوان	عنو
نجد	وجد
يسر	يسر
أنصف	نصف
ردي	ردي
لائق	ليق
صلح	صلح
قاعدة	قعد
ذهب	ذهب
مربى	ربو
عجم	عجم
أعطف	عطف
شب	شبب
إتاوة	ءتو
إدحية	دحو
عسف	عسف
خطف	خطف
جان	جنن
أمات	موت
متكدس	كدس
أبد	ءبد
توقف	وقف
قطر	قطر
شع	شعع
محاصرة	حصر
احتشاد	حشد
سؤال	سءل
أخاف	خوف
مرجع	رجع
شارع	شرع
اطرح	طرح
هندس	هندس
ابتسم	بسم
ءلف	ءلف
قار	قرر
نصت	نصت
تثنى	ثني
عقد	عقد
صفي	صفو
سبيل	سبل
اعتقل	عقل
فوز	فوز
بغى	بغي
نهض	نهض
حصاة	حصو
حاجب	حجب
ابتغى	بغي
عصيان	عصي
إصبع	صبع
مرسم	رسم
مظلم	ظلم
فهم	فهم
ربح	ربح
حزم	حزم
مقام	قوم
مؤتمر	ءمر
مسلك	سلك
كهرب	كهرب
واقع	وقع
تاب	توب
اغتصب	غصب
استيقظ	يقظ
زوجة	زوج
محدد	حدد
نخي	نخي
هادئ	هدء
تاه	توه
أورط	ورط
دان	دين
بالى	بلي
تحوط	حوط
تأخير	ءخر
تشابه	شبه
تحرم	حرم
قدم	قدم
وافق	وفق
امتحن	محن
غلى	غلي
محتمل	حمل
عجه	عجه
فدى	فدي
قحب	قحب
قرر	قرر
أشد	شدد
غرب	غرب
طغى	طغي
زرد	زرد
ركبة	برك
مجرفة	جرف
بالى	بلو
مثيل	مثل
عزز	عزز
تماسك	مسك
استقام	قوم
حلاب	حلب
قاعة	قوع
ملائك	لءك
كتابة	كتب
أحيل	حيل
صفقة	صفق
قذع	قذع
وعي	وعي
جلباب	جلبب
توضح	وضح
خروج	خرج
آض	ءيض
حقيق	حقق
أفجر	فجر
محمود	حمد
أشف	شفف
تخطف	خطف
فاجرة	فجر
صعد	صعد
قدير	قدر
نفذ	نفذ
أسأم	سءم
نكص	نكص
قبض	قبض
دنيا	دني
صفيحة	صفح
ضريبة	ضرب
صرة	صرر
حاد	حدد
شاب	شوب
كمل	كمل
أكمل	كمل
احمر	حمر
عاون	عون
عجس	عجس
حصان	حصن
أضاف	ضيف
قفز	قفز
عسر	عسر
سنة	سنن
تنحل	نحل
حفر	حفر
تفكر	فكر
ضفيرة	ضفر
سيل	سيل
جديد	جدد
مربع	ربع
عجاب	عجب
اذلعب	ذلعب
مذي	مذي
أطرى	طري
أنعظ	نعظ
شاكر	شكر
أراد	رود
خرطوم	خرطم
أعصر	عصر
استشعر	شعر
حريص	حرص
إخافة	خوف
حرث	حرث
أعاد	عود
عدى	عدو
ذوق	ذوق
أخمر	خمر
لألأ	لءلء
قابلة	قبل
أجود	جود
خشب	خشب
معصب	عصب
وجد	وجد
بكر	بكر
آلم	ءلم
تصويرة	صور
صمت	صمت
عجيل	عجل
أرسل	رسل
مذنب	ذنب
حمر	حمر
بكي	بكي
فارس	فرس
طحين	طحن
أحيل	حول
إيمان	ءمن
خلف	خلف
موافق	وفق
مبيض	بيض
بطأ	بطء
استكلب	كلب
واسع	وسع
دخان	دخن
وطن	وطن
قصر	قصر
أصح	صحح
حاق	حقق
مبيع	بيع
خادم	خدم
حكاية	حكي
سيخ	سيخ
أعرج	عرج
نقم	نقم
أصعب	صعب
فج	فجج
نجام	نجم
حب	حبب
أصغر	صغر
جمل	جمل
غلف	غلف
قليل	قلل
أقدم	قدم
صحح	صحح
تجريف	جرف
ضمني	ضمن
قرء	قرء
استكتاب	كتب
بطء	بطء
وثق	وثق
فوت	فوت
رياضة	روض
أحصن	حصن
تعامل	عمل
احقوقف	حقف
زين	زين
أمان	ءمن
عثل	عثل
طين	طين
وحيد	وحد
باقلا	بقل
قارن	قرن
رجم	رجم
نحل	نحل
تأكد	ءكد
زار	زور
سكن	سكن
غلبة	غلب
أكرب	كرب
اجتمع	جمع
تلاؤم	لءم
حملة	حمل
خمر	خمر
القدس	قدس
مطلوب	طلب
استعاذ	عوذ
خطيئة	خطء
قردس	قردس
تعديل	عدل
ضاجع	ضجع
متجر	تجر
رءي	رءي
طاف	طوف
رذذ	رذذ
خيط	خيط
تضخم	ضخم
استوضح	وضح
حاط	حوط
خيانة	خون
جراح	جرح
منارة	نور
مجهول	جهل
ميل	ميل
تأخر	ءخر
ملاقاة	لقي
نفى	نفي
عرص	عرص
نفر	نفر
تساوى	سوي
كتيب	كتب
استقطر	قطر
انتصار	نصر
أصلى	صلي
استحفاظ	حضر
أغلف	غلف
غرفة	غرف
افتتاحي	فتح
عوار	عور
ولي	ولي
أحفظ	حفظ
حرب	حرب
وثيقة	وثق
انقرض	قرض
جراحة	جرح
طاغوت	طغي
ردى	ردي
مازح	مزح
رهق	رهق
تشجر	شجر
أبرأ	برء
طرح	طرح
مدمن	دمن
تدريب	درب
أنقى	نقو
استنبأ	نبء
حالا	حول
فضض	فضض
ألهم	لهم
عمومي	عمم
غصب	غصب
فكر	فكر
هندس	هندس
ملائكة	لءك
هاجم	هجم
ممسح	مسح
امتنع	منع
قرير	قرر
اخترق	خرق
شخان	شخخ
مضايقة	ضيق
تطرف	طرف
بعض	بعض
محسبة	حسب
فاخر	فخر
معز	معز
زبال	زبل
أظلم	ظلم
دنيا	دنو
محطة	حطط
استحاء	حيو
نسق	نسق
أسوان	ءسو
استسقى	سقي
ارتجى	رجو
عائلة	عول
مقدار	قدر
أقصى	قصو
درجة	درج
ضاف	ضيف
نفي	نفي
اختار	خير
هود	هود
جاهل	جهل
أفخم	فخم
آثر	ءثر
طلع	طلع
ناهض	نهض
أصلح	صلح
داخل	دخل
انضم	ضمم
اقترب	قرب
محاربة	حرب
أبطل	بطل
شغل	شغل
خرق	خرق
ذاق	ذوق
مكدس	كدس
سابق	سبق
ذاكر	ذكر
أورث	ورث
ندد	ندد
استدر	درر
قضب	قضب
نسبة	نسب
جيش	جيش
حضر	حضر
مصورة	صور
تصريح	صرح
دام	دوم
اختلط	خلط
دقاق	دقق
قذقذ	قذقذ
عجل	عجل
بور	بور
نحر	نحر
وقب	وقب
نفذ	نفذ
صوب	صوب
مستقيم	قوم
واسطة	وسط
تضايق	ضيق
معقول	عقل
وسيلة	وسل
أصم	صمم
وحدانية	وحد
راقب	رقب
بان	بين
قحقح	قحقح
جعبة	جعب
فتور	فتر
عادي	عود
مقاطعة	قطع
عذج	عذج
قدع	قدع
قبر	قبر
عرض	عرض
السبت	سبت
بهار	بهر
مصدوم	صدم
انعمل	عمل
حدوة	حدد
رسام	رسم
بعد	بعد
جزح	جزح
مطاردة	طرد
نقيب	نقب
فطر	فطر
قتل	قتل
ماطر	مطر
عمه	عمه
توصل	وصل
رهيب	رهب
حبة	حبب
استنجد	نجد
أقدر	قدر
برنس	برنس
نهي	نهي
أخرج	خرج
وضاح	وضح
أمل	ملل
وراء	ورء
شيء	شيء
صدام	صدم
عربن	عربن
استمات	موت
كبس	كبس
فاض	فيض
صحافة	صحف
كبري	كبر
بقال	بقل
مقط	قطط
تكذب	كذب
ربح	ربح
بريء	برء
نفس	نفس
تم	تمم
اتباع	تبع
مسيح	مسح
وظيفة	وظف
دلك	دلك
جاهد	جهد
لعق	لعق
أعزل	عزل
غائم	غيم
بهيمة	بهم
جلب	جلب
مراسل	رسل
صحب	صحب
هزم	هزم
ولد	ولد
ثابر	ثبر
عصبي	عسب
صحف	صحف
أربك	ربك
ممثلة	مثل
دنيء	دنء
نظم	نظم
صادف	صدف
اشتجر	شجر
معقل	عقل
امرأة	مرء
سرب	سرب
اختفى	خفي
حقف	حقف
مضى	مضي
كسارة	كسر
غيب	غيب
دون	دون
قطار	قطر
انتقاد	نقد
طارح	طرح
رسل	رسل
مسلخ	سلخ
تأمل	ءمل
نتن	نتن
اجتماعية	جمع
إخضال	خضل
تقارض	قرض
انبسط	بسط
بهج	بهج
غنى	غني
إقامة	قوم
مجنون	جنن
غطس	غطس
ارتزق	رزق
نشئه	نشء
خطم	خطم
كسلان	كسل
خسارة	خسر
أغبى	غبي
جهد	جهد
سدس	سدس
تنور	نور
ضاع	ضيع
خاص	خصص
أمطر	مطر
نبخ	نبخ
منزل	نزل
تمسك	مسك
غبن	غبن
كاهن	كهن
أبدل	بدل
جمل	جمل
خفي	خفي
استخدام	خدم
عورة	عور
مجروح	جرح
غني	غني
مرارة	مرر
صورة	صور
استقطب	قطب
أجوف	جوف
ترافع	رفع
تجول	جول
قضى	قضي
كبر	كبر
رهينة	رهن
نعيم	نعم
اتعد	وعد
قسط	قسط
فرس	فرس
ممثل	مثل
لازم	لزم
تصوف	صوف
استكشف	كشف
نوم	نوم
شرع	شرع
تخويف	خوف
فتاة	فتي
عطف	عطف
انخفض	خفض
استطاع	طوع
يوم	يوم
خور	خور
آئب	ءوب
أبى	ءبي
عوارية	عور
مستعد	عدد
عور	عور
مريض	مرض
رق	رقق
حجم	حجم
وعد	وعد
فرحة	فرح
شاهد	شهد
عار	عير
فقد	فقد
هجران	هجر
جذاب	جذب
سكت	سكت
عذرة	عذر
نقل	نقل
قصيدة	قصد
إحضار	حضر
استقل	قلل
انسحاب	سحب
قحث	قحث
إجهاد	جهد
ذكر	ذكر
مزركش	زركش
خدش	خدش
ذريع	ذرع
حرض	حرض
جهل	جهل
تجاهل	جهل
اتحاد	وحد
طرف	طرف
أدري	دري
سمكة	سمك
جميع	جمع
جرم	جرم
حبط	حبط
فاسد	فسد
إجماع	جمع
تمرد	مرد
اقتبل	قبل
انتظم	نظم
سر	سرر
مجرى	جري
مومس	ومس
كليل	كلل
رفق	رفق
انتظر	نظر
أفضل	فضل
غرب	غرب
تفتح	فتح
ظريف	ظرف
معذرة	عذر
مفقود	فقد
مقدس	قدس
أعم	عمم
طبيعة	طبع
ملاحظة	لحظ
فار	فور
ماس	مسس
ورك	ورك
قربة	قرب
أعلن	علن
زجاج	زجج
ازدواج	زوج
أثبت	ثبت
أنقى	نقي
سرة	سرر
حقاق	حقق
ورطة	ورط
استشهد	شهد
خصوص	خصص
عدس	عدس
استوفى	وفي
عطلة	عطل
بهم	بهم
وهب	وهب
راب	روب
عجن	عجن
مشأمة	شءم
ديوان	دون
رقب	رقب
دراسة	درس
جار	جور
راشد	رشد
هدم	هندم
رحمة	رحم
وجب	وجب
ثقب	ثقب
تكلم	كلم
دفئ	دفء
هزم	هزم
التفت	لفت
عجب	عجب
أثار	ثور
استكتب	كتب
صيد	صيد
التقط	لقط
حلق	حلق
انبث	بثث
تردد	ردد
تورط	ورط
اتضح	وضح
وجس	وجس
مملوء	ملء
سعادة	سعد
نشيط	نشط
تاجر	تجر
أسمك	سمك
معقد	عقد
تنشط	نشط
دار	درر
مباحثة	بحث
رقاصة	رقص
أبله	بله
خمار	خمر
شاء	شوه
قصة	قصص
ظلم	ظلم
جذب	جذب
أستحمى	حمم
عريش	عرش
سقف	سقف
جمال	جمل
بل	بلل
صمم	صمم
فرح	فرح
غصن	غصن
تداع	دعو
ابتلع	بلع
بلدية	بلد
شراب	شرب
نجح	نجح
اختراق	خرق
حنيف	حنف
معدل	عدل
أوحش	وحش
زوج	زوج
مصنع	صنع
مأكل	ءكل
غيظ	غيظ
فريسة	فرس
نمى	نمي
تنزل	نزل
فروغ	فرغ
صنوبر	صنبر
ناقة	نوق
أخلق	خلق
قدد	قدد
تقيأ	قيء
متحف	تحف
مبالغ	بلغ
أصدق	صدق
رقد	رقد
افتعل	فعل
مداخلة	دخل
سياج	سيج
توفيق	وفق
تقرأ	قرء
ابلاج	بلج
صبيح	صبح
أملك	ملك
شغل	شغل
جاوز	جوز
عطس	عطس
غشاء	غشي
حي	حيو
مباشر	بشر
فتح	فتح
زيي	زيي
منظر	نظر
ابيض	بيض
بئس	بءس
فاتحة	فتح
دماغي	دمغ
جلل	جلل
مقراب	قرب
انفرد	فرد
أحرص	حرص
متعب	تعب
حرام	حرم
جزء	جزء
قرزل	قرزل
تفجر	فجر
سلطوية	سلط
بعوضة	بعض
عنف	عنف
قياء	قيء
حسناء	حسن
نار	نور
أحول	حول
شبث	شبث
در	درر
رصاص	رصص
ظرف	ظرف
صان	صون
أغرم	غرم
أورى	وري
كبير	كبر
كفل	كفل
صوف	صوف
ملاحقة	لحق
استخبر	خبر
قمع	قمع
غرغر	غرغر
ارتاح	روح
جهد	جهد
عسب	عسب
نمو	نمو
أشمس	شمس
ارتدى	ردي
هدف	هدف
ربع	ربع
أشقر	شقر
نعوظ	نعظ
زرد	زرد
جشع	جشع
نجار	نجر
مشجع	شجع
أرق	رقق
سمين	سمن
هاجر	هجر
نذر	نذر
قمح	قمح
جبر	جبر
عمل	عمل
حكيم	حكم
تفاوض	فوض
مكتبة	كتب
حسابة	حسب
مجامعة	جمع
بطالة	بطل
وفى	وفي
نظرية	نظر
شوك	شوك
جرد	جرد
وصى	وصي
تلون	لون
عاهل	عهل
مجادلة	جدل
إبطاء	بطء
عشر	عشر
أسير	ءسر
تعارف	عرف
خذل	خذل
مسد	مسد
قيد	قيد
لاعب	لعب
تخفى	خفي
نجد	نجد
عتو	عتو
أدهش	دهش
نافع	نفع
ضال	ضلل
حجاب	حجب
تعاكس	عكس
صياد	صيد
لعاب	لعب
أثني	ثني
أول	ءول
بان	بون
حصار	حصر
تنافسي	نفس
نجا	نجو
استسلام	سلم
ارتجل	رجل
أذاع	ذيع
أسفر	سفر
قبر	قبر
عسل	عسل
بارى	بري
إنشاء	نشء
مذهب	ذهب
سبح	سبح
صغير	صغر
قحد	قحد
احدودق	حدق
مستحيل	حول
شاب	شيب
حجة	حجج
خليص	خلص
ختم	ختم
أبصر	بصر
طرطور	طرطر
جزاء	جزي
بخل	بخل
ءلل	ءلل
متسامح	سمح
دواء	دوي
خليق	خلق
انجرف	جرف
مصلى	صلو
زخرف	زخرف
تدبير	دبر
أليس	ليس
وعثاء	وعث
دحرج	دحرج
زاوية	زوي
ائتلف	ءلف
مخبأ	خبء
آت	ءتي
تجر	تجر
عرد	عرد
بصير	بصر
أردأ	ردء
عارض	عرض
عرج	عرج
محبس	حبس
القاعدة	قعد
شد	شدد
مصر	صرر
شراك	شرك
حيلة	حول
صدق	صدق
حسر	حسر
جرعة	جرع
ممسحة	مسح
جاسوسة	جسس
ابتهج	بهج
تكدس	كدس
إيالة	ءول
معرق	عرق
عجف	عجف
همزة	همز
صادر	صدر
محكمة	حكم
حطم	حطم
أبق	ءبق
خوف	خوف
مطلع	طلع
غرد	غرد
غمامة	غمم
عثن	عثن
عرقص	عرقص
أولى	ولي
عتن	عتن
أعرف	عرف
وقف	وقف
مناسبة	نسب
بين	بين
مسفوح	سفح
أصفى	صفو
تكبر	كبر
أخذ	ءخذ
تجربة	جرب
عرتن	عرتن
أذكى	ذكو
تعفن	عفن
دير	دير
كساء	كسو
حف	حفف
بدا	بدو
نشر	نشر
أربعة	ربع
ثقل	ثقل
عين	عين
أطزج	طزج
زوج	زوج
كشف	كشف
متوسط	وسط
بليغ	بلغ
تقدس	قدس
شربة	شرب
غلط	غلط
مرابط	ربط
طل	طلل
عجرف	عجرف
شرك	شرك
سطر	سطر
عيان	عيي
تفرغ	فرغ
ثبت	ثبت
قسم	قسم
ترقب	رقب
أيمن	ءمن
بارد	برد
قرة	قرر
نفد	نفد
فجأة	فجء
عاشق	عشق
ابتلى	بلي
طعن	طعن
فضل	فضل
واعد	وعد
افترض	فرض
صفاء	صفو
مسعى	سعي
هدوء	هدء
هال	هول
مغطس	غطس
دوي	دوي
نبات	نبت
مدونة	دون
عيان	عين
ظهران	ظهر
موقع	وقع
خضع	خضع
سلعة	سلع
قطمة	قطم
عدن	عدن
محراب	حرب
تفسير	فسر
قماش	قمش
عصم	عصم
أعمر	عمر
لقي	لقي
قال	قيل
أعور	عور
حبيب	حبب
غطاء	غطو
نظير	نظر
صانع	صنع
ضايق	ضيق
موت	موت
فخر	فخر
أرضى	رضي
تمكن	مكن
استعجل	عجل
ثوب	ثوب
غور	غور
مكوى	كوي
مجتمع	جمع
ساء	سوء
وصل	وصل
مفضل	فضل
تزوى	زوي
إبدال	بدل
دجاجة	دجج
مقص	قصص
أوفر	وفر
تعادل	عدل
ران	رين
رقب	رقب
نسيئة	نسء
مدعى	دعو
رباعي	ربع
منبع	نبع
باطن	بطن
أغلظ	غلظ
عجول	عجل
خذل	خذل
نقطة	نقط
توعية	وعي
تبن	ثني
ساقة	سوق
بنيان	بني
كره	كره
أحمل	حمل
خل	خلل
معمار	عمر
طيارة	طير
مومسة	ومس
فجائي	فجء
احتشد	حشد
منطقة	نطق
موقد	وقد
حطم	حطم
سعى	سعي
انفعل	فعل
استمنى	مني
صاف	صفو
تغيب	غيب
رفرف	رفرف
أنام	نوم
قتل	قتل
صرح	صرح
سجين	سجن
انتحل	نحل
خشونة	خشن
أعزب	عزب
فراغ	فرغ
موضع	وضع
تقبض	قبض
لغة	لغو
اقتضب	قضب
انعكس	عكس
كفاءة	كفء
اخشوشن	خشن
أبلغ	بلغ
مدفأ	دفء
شجع	شجع
تكفيري	كفر
أوحد	وحد
حسان	حسن
جرافة	جرف
تزوج	زوج
أنيق	ءنق
تبالد	بلد
مزعج	زعج
برئ	برء
فرج	فرج
أجلد	جلد
ضاد	ضدد
ثأر	ثءر
حظي	حظو
عطر	عطر
قهر	قهر
مصعد	صعد
أفنى	فني
خضل	خضل
أجلاء	جلل
قاء	قيء
جرح	جرح
عقاب	عقب
انكسر	كسر
فريد	فرد
فتاح	فتح
مرهم	رهم
مركب	ركب
إعدام	عدم
اخضوضر	خضر
مثانة	ثني
هزز	هزز
رطب	رطب
حيو	حيو
حليب	حلب
اجلنفع	جلفع
صبا	صبو
قين	قين
حطب	حطب
بيت	بيت
محادث	حدث
نقاب	نقب
تذكر	ذكر
فارغ	فرغ
صادق	صدق
أدب	ءدب
ناجد	نجد
اليمن	يمن
معير	عور
استكره	كره
رونق	روق
عافية	عفو
تصادر	صدر
ردي	ردي
قيقب	قبب
ضرب	ضرب
ارتفع	رفع
جاسوس	جسس
أعلم	علم
دبور	دبر
خفف	خفف
مدى	مدي
قثم	قثم
بالهناءوالشفاء	هنء
شاء	شيء
مضيء	ضوء
نقد	نقد
عرق	عرق
حماض	حمض
فوز	فوز
كرب	كرب
قسط	قسط
مشهور	شهر
نسل	نسل
بالغ	بلغ
احتاج	حوج
زمان	زمن
عجم	عجم
مطار	طير
فسا	فسو
استدعى	دعو
بلاغ	بلغ
أذهب	ذهب
ودع	ودع
وفاة	وفي
عزل	عزل
لعن	لعن
قتع	قتع
نزف	نزف
هجم	هجم
عبم	عبم
ممحوق	محق
عج	عجج
هباء	هبو
انسحب	سحب
حوي	حوي
سراب	سرب
رج	رجج
ءوي	ءوي
بيع	بيع
أنزل	نزل
كثيب	كثب
مساء	مسو
أحق	حقق
ضاء	ضوء
سم	سمم
زهد	زهد
دقع	دقع
تجميل	جمل
تكديس	كدس
مدن	مدن
ضعيف	ضعف
مسخرة	سخر
أغير	غير
استبعد	بعد
دافئ	دفء
سلط	سلط
رسول	رسل
اندلع	دلع
بدلة	بدل
قحو	قحو
تحدث	حدث
أزعر	زعر
وطئ	وطء
قدس	قدس
سلمان	سلم
غلف	غلف
تدخل	دخل
صدر	صدر
بينونة	بين
إنسان	ءنس
صابح	صبح
منقض	نقض
مستثنى	ثني
عميد	عمد
إيا	ءيء
فكر	فكر
محاصر	حصر
أكلب	كلب
أجرى	جري
نقص	نقص
تبليغ	بلغ
عزلة	عزل
تحريضي	حرض
قنطرة	قنطر
زبور	زبر
زيد	زيد
تسكن	سكن
دعاء	دعو
أسرع	سرع
زكام	زكم
قبض	قبض
استورط	ورط
سرع	سرع
محفل	حفل
محاكمة	حكم
وجد	وجد
هيئة	هيء
قلق	قلق
نجمة	نجم
شجر	شجر
وفير	وفر
محرمة	حرم
بناء	بني
ضم	ضمم
مهلة	مهل
حلاق	حلق
حتى	عتي
خشن	خشن
شخص	شخص
طير	طير
مشغول	شغل
وجل	وجل
نكر	نكر
انفطر	فطر
اتخاذ	ءخذ
أقط	قطط
صدفة	صدف
زرع	زرع
وحد	وحد
حصى	حصو
سفك	سفك
استرجل	رجل
رتيب	رتب
عثكل	عثكل
الرب	ربب
فصل	فصل
خصى	خصي
دمر	دمر
ممل	ملل
خطة	خطط
نادى	ندو
عشرة	عشر
محقق	حقق
استبدل	بدل
ارتبك	ربك
لوح	لوح
ركب	ركب
اعتنى	عني
قاوم	قوم
شيح	شيع
تحرف	حرف
جل	جلل
ندي	ندو
اقشعر	قشعر
عقل	عقل
تسمم	سمم
تلحين	لحن
قنطر	قنطر
ملء	ملء
سمح	سمح
مجيء	جيء
ناظر	نظر
تمثل	مثل
وطن	وطن
مؤلف	ءلف
نسخ	نسخ
شغف	شغف
بارز	برز
استقال	قيل
عبوة	عبو
حارة	حور
قضيب	قضب
قطعة	قطع
سهل	سهل
عور	عور
انتبه	نبه
إجراء	جري
كذب	كذب
وطء	وطء
وعي	وعي
محارب	حرب
رفع	رفع
اكتشف	كشف
جدد	جدد
ابتداء	بدء
مسار	سير
حدد	حدد
حيال	حول
شامس	شمس
خدر	خدر
تبدل	بدل
رءس	رءس
غذا	غذو
انفجر	فجر
جمعي	جمع
أخفش	خفش
إحياء	حيو
خزينة	خزن
صبح	صبح
اغتال	غول
دبر	دبر
اقترض	قرض
مجلة	جلل
انتشر	نشر
برقع	برقع
ورث	ورث
أكثر	كثر
صام	صوم
لبث	لبث
عجل	عجل
حواية	حوي
كميل	كمل
كارثة	كرث
أقل	قلل
وسط	وسط
استعرب	عرب
أميز	ميز
تقاطع	قطع
غلاف	غلف
تيسر	يسر
كفى	كفي
شمس	شمس
مدع	دعو
أحر	حرر
ألزم	لزم
ندد	ندد
متكتل	خطط
أدحوة	دحو
حجرة	حجر
خزانة	خزن
قائمة	قوم
تقابل	قبل
اشمأز	شمءز
ظهر	ظهر
عقم	عقم
استقتل	قتل
طار	طير
أجدر	جدر
أطرش	طرش
ترجم	ترجم
أسفل	سفل
طاول	طول
أشجر	شجر
غير	غير
نعام	نعم
شكل	شكل
هوي	هوي
شقوة	شقو
فرخ	فرخ
سربال	سربل
وكيل	وكل
طيف	طيف
أشرك	شرك
اقتصاد	قصد
زعم	زعم
بنية	بني
عرت	عرت
أرضع	رضع
لاسلطوي	سلط
ازدرد	زرد
ضرس	ضرس
أوجد	وجد
تأثر	ءثر
شارب	شرب
تنبأ	نبء
جدد	جدد
خلد	خلد
شعر	شعر
كرسي	كرس
موجود	وجد
إثناء	ثني
تجريح	جرح
حبيبة	حبب
استرد	ردد
ضرورة	ضرر
اضطر	ضرر
نوى	نوي
نجد	نجد
مقفول	قفل
حزين	حزن
تحت	تحت
اخرنمس	خرمس
مضحك	ضحك
خصص	خصص
طابع	طبع
تلفظ	لفظ
امتحان	محن
منصب	نصب
ابتأس	بءس
مصدر	صدر
افتتح	فتح
جلالة	جلل
كريم	كرم
ضخ	ضخخ
أدق	دقق
إتجاه	وجه
جزيرة	جزر
أباع	بيع
أمجد	مجد
أسبق	سبق
عضو	عضو
متحد	وحد
تفريغ	فرغ
مؤسس	ءسس
أنقض	قضي
تواقف	وقف
لاسلطوية	سلط
وزن	وزن
راهب	رهب
أقتل	قتل
معدوم	عدم
مروش	روش
عام	عمم
سار	سرر
تجانس	جنس
آخر	ءخر
اكتفى	كفي
عد	عدد
خصص	خصص
قرن	قرن
وقف	وقف
استدعاء	دعو
التزام	لزم
ثني	ثني
شاب	شبب
شرم	شرم
فورا	فور
نطيطة	نطنط
مبتل	بلي
غيمة	غيم
خلى	خلو
ازدوج	زوج
كافأ	كفء
مجاملة	جمل
خول	خول
وصفة	وصف
حكم	حكم
منتقض	نقض
تواصى	وصي
سن	سنن
انكتب	كتب
تداول	دول
أسوى	سوي
عبهل	عبهل
هم	همم
بطل	بطل
قسمة	قسم
انهزم	هزم
أقال	قيل
كان	كون
تدبر	دبر
اتفق	وفق
رفض	رفض
خبز	خبز
مسؤول	سءل
قدو	قدو
نحر	نحر
تعشى	عشي
محادثة	حدث
جملة	جمل
صناعة	صنع
منتج	نتج
استمتع	متع
شيخ	شيخ
انطباع	طبع
أخضل	خضل
أحسن	حسن
كثر	كثر
تصدر	صدر
شاء	شوء
قصير	قصر
شركة	شرك
ملبس	لبس
دليل	دلل
خامر	خمر
قابل	قبل
خد	خدد
استحسان	حسن
فرد	فرد
صاد	صيد
مملكة	ملك
ألذ	لذذ
مبادلة	بدل
فقير	فقر
تسلح	سلح
كلم	كلم
اشتهر	شهر
خطوة	خطو
أحد	وحد
شلوار	سبل
ناول	نول
لحد	لحد
دين	دين
زرع	زرع
موكب	وكب
قرز	قرز
فات	فوت
نشء	نشء
وصل	وصل
ثديي	ثدي
سفر	سفر
هيف	هيف
أبيض	بيض
خرا	خرء
تمدن	مدن
نكر	نكر
استعمال	عمل
طفا	طفو
وسم	وسم
صلح	صلح
تحريض	حرض
حساس	حسس
تقطب	قطب
ربب	ربب
اتخذ	ءخذ
عراء	عري
مشناه	ثني
حوار	حور
عصب	عصب
سيل	سيل
جهاد	جهد
اتبع	تبع
بغي	بغي
بذلة	بذل
عين	عين
سائق	سوق
كعبة	كعب
أرحب	رحب
سجد	سجد
أنشأ	نشء
أنور	نور
ألحق	لحق
أوى	ءوي
أشهد	شهد
قرصب	قرصب
سخط	سخط
جمع	جمع
قطف	قطف
شعل	شعل
مغلف	غلف
رزق	رزق
بلاد	بلد
تمرين	مرن
مجاز	جوز
حفيدة	حفد
محص	محص
وحد	وحد
مجراف	جرف
ضأن	ضءن
سليم	سلم
صبح	صبح
ركض	ركض
ابتعاد	بعد
أنحل	نحل
تعالم	علم
نور	نور
فاحشة	فحش
القطيف	قطف
أحمد	حمد
حشد	حشد
سمع	سمع
عظيم	عظم
سحلية	سحل
ثمرة	ثمر
حدث	حدث
أزب	زبب
حاسوب	حسب
اشتق	شقق
لوحة	لوح
أجهل	جهل
كاهنة	كهن
يسار	يسر
تعليق	علق
ثقيل	ثقل
شعله	شعل
استند	سند
امتد	مدد
أنصت	نصت
كرم	كرم
مضبوط	ضبط
جانب	جنب
حافظة	حفظ
كسب	كسب
ورد	ورد
ظاهر	ظهر
خسأ	خسء
ءكل	ءكل
عقدة	عقد
عجرم	عجرم
مزرع	زرع
تحفيظ	حضر
تطارح	طرح
شهد	شهد
عري	عري
بات	بتت
خجل	خجل
خابر	خبر
قفل	قفل
ود	ودد
هزيمة	هزم
قارب	قرب
عفن	عفن
صد	صدد
أتقن	تقن
غائب	غيب
فقس	فقس
وكالة	وكل
تذمر	ذمر
ثبر	ثبر
رشيد	رشد
دفع	دفع
رخيص	رخص
هدد	هدد
أرطب	رطب
ذريعة	ذرع
ساق	سوق
نشافة	نشف
مضخة	ضخخ
أصل	ءصل
عرمض	عرمض
زبدة	زبد
كعك	كعك
رطيب	رطب
خد	ءخذ
إبلاغ	بلغ
خفت	خفت
تب	تبب
استقر	قرر
عجاج	عجج
جيد	جود
صدف	صدف
نزل	نزل
قدر	قدر
ندم	ندم
تغذية	غذو
حيا	حيو
احتمالا	حمل
ثلث	ثلث
عود	عود
أردف	ردف
ضلع	ضلع
قرش	قرش
ادعى	دعو
مقتل	قتل
خطئ	خطء
مرير	مرر
تساقط	سقط
سارق	سرق
صدع	صدع
سام	سمو
داء	دوي
صور	صور
حلم	حلم
أعدل	عدل
يقظ	يقظ
مرتبك	ربك
تخابر	خبر
انثنى	ثني
أصلب	صلب
حزب	حزب
سماء	سمو
استضاء	ضوء
اتكأ	وكء
مدير	دور
أعرق	عرق
أمهر	مهر
استفراغ	فرغ
معزف	عزف
ممطرة	مطر
اختطاف	خطف
عهر	عهر
ساحة	سوح
ظن	ظنن
انحمال	حمل
إياك	ءيء
بهتان	بهت
خضرة	خضر
سرق	سرق
أوفق	وفق
ثانية	ثني
تصبر	صبر
أحرم	حرم
ريشة	ريش
صدق	صدق
حاجة	حوج
لحن	لحن
زحافة	زحف
أوجه	وجه
ملعب	لعب
خبر	خبر
نعسان	نعس
حقيقي	حقق
رمز	رمز
مثن	مثن
ثني	ثني
تشاءم	شءم
قرش	قرش
مرن	مرن
توكأ	وكء
برهان	برء
مات	موت
إدمان	دمن
إبهام	بهم
فتى	فتي
حقق	حقق
محافظة	حفظ
أيقظ	يقظ
رياضيات	روض
مولى	ولي
كاسب	كسب
أسمح	سمح
سعد	سعد
تساند	سند
اعتمر	عمر
عذراء	عذر
أحضر	حضر
تطرح	طرح
العراق	عرق
أفق	ءفق
ناوى	نوي
ذرع	ذرع
بهت	بهت
تناوم	نوم
سهل	سهل
لبس	لبس
قذر	قذر
وجيه	وجه
غريب	غرب
ضغط	ضغط
برنس	برنس
أشيب	شيب
غلاية	غلي
أدحي	دحو
ذر	ذرر
نشرة	نشر
كراهية	كره
ارجحن	رجحن
تخبط	خبط
فسر	فسر
ثوب	ثوب
شوكة	شوك
سكين	سكن
مسابقة	سبق
كوثر	كثر
متصل	وصل
تعب	تعب
منظمة	نظم
اتصل	وصل
أذكى	ذكي
استعار	عور
بشرى	بشر
نحل	نحل
أنار	نور
قاس	قيس
لاقى	لقي
كيان	كون
صوفي	صوف
تساكن	سكن
ءخذ	ءخذ
ردف	ردف
برك	برك
تصلى	صلي
إمار	ءمر
سمي	سمو
فارع	فرع
ختم	ختم
صبور	صبر
تحسن	حسن
زهر	زهر
كرب	كرب
ابتدأ	بدء
الله	ءله
حنف	حنف
تبارك	برك
استجماع	جمع
حوى	حوي
لعبة	لعب
شرك	شرك
لعب	لعب
تضوأ	ضوء
غرد	غرد
ثلة	ثلل
عبء	عبء
خزن	خزن
ليس	شيء
سلم	سلم
أجمع	جمع
أقرب	قرب
عض	عضض
زمر	زمر
افتتاح	فتح
قبل	قبل
حنى	حني
تحفظ	حفظ
احترام	حرم
نكف	نكف
مرض	مرض
ميل	ميل
أناب	نوب
شوف	شوف
عام	عوم
تحوى	حوي
انتفخ	نفخ
فوار	فور
فائدة	فيد
مخنث	خنث
متعمد	عمد
هواية	هوي
مضغ	مضغ
إقالة	قيل
أمام	ءمم
فخور	فخر
مناقض	نقض
نجاح	نجح
ألا	ءلو
استوقف	وقف
مقايسة	قيس
أدوم	دوم
أسخن	سخن
واجه	وجه
معلوم	علم
منطق	نطق
قدم	قدم
ضاق	ضيق
قوي	قوي
احمرار	حمر
عظم	عظم
جر	جرر
نقض	قضي
غال	غلو
زهرة	زهر
مشهود	شهد
أسرف	سرف
جصص	جصص
أسلك	سلك
أرد	ردد
ليقة	ليق
فتح	فتح
خرج	خرج
إرهاب	رهب
مص	مصص
أخبر	خبر
وال	ولي
قرعة	قرع
أدبر	دبر
ابتعد	بعد
تحميل	حمل
عدق	عدق
تخليق	خلق
صنف	صنف
أقرأ	قرء
صار	صير
ولاعة	ولع
قصب	قصب
ازداد	زيد
إسوة	ءسو
حريم	حرم
حلب	حلب
أخصب	خصب
انحرف	حرف
كرر	كرر
عمل	عمل
خطير	خطر
أدمن	دمن
هبوب	هبب
ترتيب	رتب
تبرير	برر
تلقى	لقي
ذرى	ذري
بناية	بني
استحرم	حرم
نتن	نتن
لفاف	لفف
عسعس	عسعس
عدم	عدم
تصدق	صدق
جمهور	جمهر
رأس	رءس
برقع	رقع
أوقف	وقف
ورط	ورط
وقى	وقي
خون	خون
اقتضى	قضي
استحم	حمم
حكة	حكك
ممسوح	مسح
شبه	شبه
حد	حدد
قتد	قتد
مقال	قول
عرج	عرج
شيع	شيع
عرم	عرم
معجون	عجن
تسامح	سمح
فحشاء	فحش
استحضر	حضر
أرى	رءي
فتاة	فتو
طلح	طلح
بسر	بسر
أضعف	ضعف
إشاعة	شيع
فرقة	فرق
أشاد	شيد
اشتقاق	شقق
عبر	عبر
ورع	ورع
وضعة	وضع
مبارزة	برز
بادل	بدل
ترجم	ترجم
مرادف	ردف
شقة	شقق
مرجيحة	رجح
حاصر	حصر
مساواة	سوي
منقول	نقل
عزم	عزم
تخدير	خدر
بركة	برك
نفاذ	نفذ
تبع	تبع
أفاض	فيض
عدف	عدف
مرج	مرج
استحى	حيو
أضحك	ضحك
تاءمربوطة	ربط
سلسل	سلسل
مغرب	غرب
قص	قصص
تخجيل	خجل
إطار	ءطر
تفاعل	فعل
غابة	غيب
تأزم	ءزم
أرغن	رغن
فزع	فزع
استفرغ	فرغ
لاجئ	لجء
عرس	عرس
رب	ربب
شرف	شرف
عري	عري
مذبحة	ذبح
أروح	روح
محظوظ	حظظ
كفر	كفر
حجر	حجر
قبلا	قبل
عرف	عرف
استنسب	نسب
قديم	قدم
حوش	حوش
كحل	كحل
استبد	بدد
أبرق	برق
شتم	شتم
إتيان	ءتي
مجمد	جمد
مشي	مشي
عذق	عذق
ضحك	ضحك
أدار	دور
ناعم	نعم
نحو	نحو
فوضوية	فوض
نبي	نبء
مستوى	سوي
غيور	غير
دابة	دبب
جد	جدد
هاتف	هتف
غسل	غسل
مرد	مرد
أيسر	يسر
سجادة	سجد
جنب	جنب
خضوع	خضع
منوم	نوم
حرم	حرم
أفرغ	فرغ
واعظ	وعظ
أجرب	جرب
قوى	قوي
كف	كفف
مصور	صور
أجمل	جمل
توجد	وجد
كثيرا	كثر
أخف	خفف
سرب	سرب
صارخ	صرخ
غض	غضض
فسق	فسق
ملأك	لءك
عربد	عربد
تعفج	عفج
عثث	عثث
راب	ريب
عاكس	عكس
حمى	حمي
سلف	سلف
إتعاب	تعب
خمس	خمس
الجمعة	جمع
واتر	وتر
عالج	علج
اخترع	خرع
رباط	ربط
حيوت	حيو
حوادث	حدث
احتفل	حفل
تثبت	ثبت
ارثعن	رثعن
سترة	ستر
درس	درس
غير	غير
غليظ	غلظ
عدو	عدو
جزر	جزر
مطر	مطر
حصوة	حصي
تترس	ترس
أشحب	شحب
مسلول	سلل
شهر	شهر
احترب	حرب
تيقظ	يقظ
اشترك	شرك
مستفرغ	فرغ
تخيل	خيل
نظم	نظم
ولي	ولي
زيارة	زور
شريعة	شرع
مسلسل	سلسل
وسيم	وسم
فخذ	فخذ
حاسة	حسس
ممكن	مكن
حوك	حوك
انتوى	نوي
معى	معي
دفق	دفق
شغف	شغف
مجتهد	جهد
طاع	طوع
طباخ	طبخ
حامل	حمل
حجز	حجز
خسئ	خسء
صلب	صلب
كبيس	كبس
صحيفة	صحف
نبخ	نبخ
اعوج	عوج
أبلع	بلع
سوء	سوء
غداء	غدو
كافر	كفر
مكمل	كمل
قرصن	قرصن
ترد	ردي
بيئة	بوء
نعظ	نعظ
زال	زيل
أحس	حسس
ضرر	ضرر
سبورة	سبر
راكب	ركب
عطو	عطو
نقض	نقض
وفر	وفر
برهان	بره
أبقى	بقي
متعة	متع
صفح	صفح
مدفأة	دفء
تفاهم	فهم
كمون	كمن
لغو	لغو
مندثر	دثر
مرحبا	رحب
شم	شمم
تشاغل	شغل
ترجل	رجل
فز	فزز
شعبة	شعب
رئيس	رءس
كادس	كدس
مكر	مكر
رحم	رحم
خدمة	خدم
تزخرف	زخرف
مبان	بين
سجد	سجد
اخضوضع	خضع
نكبة	نكب
وجب	وجب
جيء	جيء
موج	موج
أدى	ءدي
اعتبر	عبر
مستمر	مرر
أسمن	سمن
سجا	سجو
احدودب	حدب
راجل	رجل
تحية	حيو
أملح	ملح
قراءة	قرء
حيوات	حيو
أسي	ءسو
مشمئز	شمءز
أحيا	حيو
جهر	جهر
ماسح	مسح
باق	بقي
تعب	تعب
تهيأ	هيء
حلم	حلم
عرش	عرش
أنجز	نجز
عقيم	عقم
تحاب	حبب
أعنف	عنف
زين	زين
زلزل	زلزل
أجذب	جذب
ازاي	زيي
لحظ	لحظ
برز	برز
عدد	عدد
انبثق	بثق
جسيم	جسم
تفطر	فطر
رصاصة	رصص
قرصة	قرص
سيئ	سوء
صحن	صحن
ظاهرة	ظهر
مقدرة	قدر
ملف	لفف
دافع	دفع
باطل	بطل
ممر	مرر
كيف	كيف
مغسلة	غسل
دحو	دحو
متقدم	قدم
أدنى	دنو
مساحة	مسح
قبع	قبع
قيافة	قيف
قرس	قرس
تزين	زين
نعامة	نعم
احتياط	حوط
طفولة	طفل
إحقاق	حقق
قضية	قضي
أليق	ليق
مفتوح	فتح
أسبغ	سبغ
اصطدم	صدم
سرية	سرر
نصح	نصح
فجر	فجر
صعب	صعب
وقع	وقع
كون	كون
كثير	كثر
استأمن	ءمن
تنظيم	نظم
استفز	فزز
نبء	نبء
افتقر	فقر
ترك	ترك
تحشيد	حشد
بوق	بوق
تفرق	فرق
ذرا	ذرو
اتنين	ثني
منشفة	نشف
انجذاب	جذب
عون	عون
قليب	قلب
تام	تمم
مثقف	ثقف
نهر	نهر
خطبة	خطب
نصب	نصب
حضيض	حضض
تكتيب	كتب
جدال	جدل
مؤاخذ	ءخذ
أمة	ءمو
أهان	هون
أفرع	فرع
حفظ	حفظ
جيش	جيش
أنقذ	نقذ
هاد	هود
دحو	دحو
سلطة	سلط
أطاع	طوع
وازى	وزي
مواطن	وطن
حلال	حلل
احتفظ	حفظ
استصواب	صوب
ظرفية	ظرف
صندوق	صندق
تكفير	كفر
أجلة	جلل
مغضوب	غضب
جاف	جفف
ءمن	ءمن
محن	محن
اتحد	وحد
مقداد	قدد
أغلى	غلو
عمر	عمر
التمس	لمس
اعتزم	عزم
أحصى	حصي
انتقض	نقض
أنقض	نقض
جسد	جسد
ءول	ءول
مر	مرر
لامس	لمس
حول	حول
لمز	لمز
جزى	جزي
مكسور	كسر
لحاف	لحف
اعتراض	عرض
وصب	وصب
كذب	كذب
استمع	سمع
أحكم	حكم
نظر	نظر
أوضح	وضح
انحمل	حمل
صنبور	صبر
جوار	جور
كنيسة	كنس
ثبت	ثبت
تخشب	خشب
خؤون	خون
دندن	دندن
شدد	شدد
تغدى	غدو
رادف	ردف
ماحق	محق
مطعم	طعم
قطيفة	قطف
ذبابة	ذبب
تقطر	قطر
أودى	ودي
ابتذل	بذل
كرم	كرم
هدية	هدي
جلال	جلل
فتى	فتو
أمسك	مسك
ماسورة	ءسر
أمكن	مكن
نساء	نسو
نسء	نسء
مصلحة	صلح
ذئب	ذءب
أسرى	سري
مغسل	غسل
تخفيض	خفض
مكن	مكن
تحاسب	حسب
كسل	كسل
عتعت	عتعت
استنار	نور
ربى	ربو
قذي	قذي
شفى	شفي
وضح	وضح
أوسع	وسع
مفتش	فتش
عظم	عظم
فوارة	فور
ورق	ورق
محتلم	حلم
متعهد	عهد
شنق	شنق
وصف	وصف
تناسب	نسب
حداثة	حدث
زينة	زين
قارة	قرر
وصية	وصي
مشرب	شرب
خمسة	خمس
استحرام	حرم
بخار	بخر
نفق	نفق
ضيف	ضيف
جدوى	جدو
ممرض	مرض
بلد	بلد
أضاء	ضوء
ذرة	ذرر
طال	طول
سبب	سبب
تعاير	عير
شريك	شرك
أخشن	خشن
صاحب	صحب
تسلى	سلو
أتعب	تعب
نعظ	نعظ
سيب	سيب
أصبح	صبح
رفيق	رفق
مجد	مجد
شعار	شعر
سرعة	سرع
كدس	كدس
اخرنطم	خرطم
بال	بول
عهد	عهد
أظهر	ظهر
خير	خير
لفافة	لفف
يرقة	يرق
لقب	لقب
تطول	طول
آمن	ءمن
ساوى	سوي
تعمل	عمل
عاصمة	عصم
جهل	جهل
رش	رشش
شدة	شدد
التهم	لهم
ذيل	ذلل
دهش	دهش
بحر	بحر
قبقب	قبقب
سرير	سرر
اغترب	غرب
ماثل	مثل
بوق	بقق
استكف	كفف
صالح	صلح
فضة	فضض
سفينة	سفن
تفرس	فرس
جنوب	جنب
منار	نور
تمنى	منو
أفسل	فسل
ولد	ولد
خصلة	خصل
إحصاء	حصي
ماء	موه
مخزن	خزن
دار	دور
شاجر	شجر
محجوب	حجب
احتفاظ	حضر
كيول	كيل
تدور	دور
قدرة	قدر
أحلى	حلو
طوع	طوع
زي	زيي
قاع	قوع
أفعل	فعل
دائرة	دور
سبق	سبق
صك	صكك
شرى	شري
تهرب	هرب
حزام	حزم
حنا	حنو
برء	برء
عار	عري
تخمر	خمر
مخامرة	خمر
علي	علي
قلم	قلم
عقم	عقم
سرية	سري
طريق	طرق
أمانة	ءمن
منجم	نجم
نحت	نحت
محاققة	حقق
فور	فور
ضمان	ضمن
مركبة	ركب
ذباب	ذبب
ناقش	نقش
قحز	قحز
انتسب	نسب
مسل	سلي
خسر	خسر
معاينة	عين
حياء	حيو
فدية	فدي
ظلمة	ظلم
تخوف	خوف
لخص	لخص
صفعة	صفع
لص	لصص
ساهم	سهم
أرخص	رخص
حلمة	حلم
تبول	بول
زحر	زحر
نطق	نطق
صحي	صحو
رفاع	رفع
أزهر	زهر
امتثل	مثل
إجازة	جوز
نمق	نمق
قحثر	قحثر
جبل	جبل
مهتم	همم
أقبل	قبل
أخضر	خضر
قديس	قدس
تحويط	حوط
أضاع	ضيع
بتر	بتر
حبل	حبل
أعلى	علي
قاسم	قسم
عشب	عشب
أشكل	شكل
بائس	بءس
أجاب	جوب
سال	سيل
قارض	قرض
عشق	عشق
جوا	جيء
حضرة	حضر
استحمال	حمل
لباس	لبس
حوط	حوط
حراب	حرب
شجاع	شجع
خرص	خرص
صدع	صدع
ملاحظ	لحظ
خاف	خوف
هنأ	هنء
سعر	سعر
رتبة	رتب
جيد	جيد
تسرب	سرب
عذب	عذب
أثنى	ثني
قبيح	قبح
أسمى	سمو
عدا	عدو
حال	حول
غليون	غلي
عبا	عبو
أسن	سنن
أعش	عشش
اكتتاب	كتب
معطف	عطف
جرف	جرف
شائعة	شيع
ضائن	ضءن
حمل	حمل
باح	بوح
ضرط	ضرط
أعار	عور
متعدد	عدد
فرصة	فرص
نحف	نحف
قردح	قردح
فشل	فشل
شهلاء	شهل
لامبالاة	بلي
كوت	كوت
ضيع	ضيع
صفر	صفر
خلط	خلط
شنق	شنق
قرر	قرر
عذل	عذل
طبيب	طبب
حدب	حدب
اتسخ	وسخ
تعطى	عطو
متفوق	فوق
تسرى	سرر
طرح	طرح
قرين	قرن
ضوء	ضوء
أمد	مدد
عذر	عذر
إبان	ءبن
بحاح	بحح
هائل	هول
سلس	سلس
سوف	سوف
قرصن	قرصن
أنهى	نهي
سهلا	سهل
استوطن	وطن
حوائج	حوج
شخص	شخص
تباكى	بكي
متميز	ميز
شاخ	شيخ
طوع	طوع
مال	مول
صلى	صلي
خلق	خلق
استعلم	علم
قفر	قفر
فلك	فلك
عبري	عبر
لاح	لوح
قرزم	قرزم
حتى	حتت
مسن	سنن
نبح	نبح
حبلى	حبل
كتب	كتب
تنقض	قضي
قذف	قذف
فرحان	فرح
ألف	ءلف
تمنى	مني
ذهل	ذهل
حنى	حنو
مثالي	مثل
فاتح	فتح
مرفق	رفق
شفقة	شفق
مداخل	دخل
مكنسة	كنس
طاولة	طول
تذبذب	ذبذب
نشأ	نشء
مآت	ءتي
أرشد	رشد
فجوة	فجو
غالب	غلب
قريب	قرب
تحمل	حمل
أدحية	دحو
تجنب	جنب
فسل	فسل
أخوف	خوف
شتو	شتو
حامد	حمد
عراك	عرك
تمذهب	ذهب
دقة	دقق
صمام	صمم
عديد	عدد
حج	حجج
أزال	زول
ساخن	سخن
ركل	ركل
قبيلة	قبل
هواء	هوي
تكاثر	كثر
ذكي	ذكي
كسر	كسر
تبغ	تبغ
تأصل	ءصل
خلف	خلف
سبعة	سبع
لمس	لمس
برق	برق
أضرب	ضرب
لؤلؤة	لءلء
حصاة	حصي
مطبخ	طبخ
توازى	وزي
متزمت	زمت
كرر	كرر
خلية	خلو
غل	غلل
الكويت	كوت
حمر	حمر
كاف	كفي
أخفض	خفض
عرف	عرف
رحض	رحض
مصحف	صحف
مازج	مزج
خياط	خيط
قنطر	قنطر
طول	طول
وسع	وسع
غسل	غسل
زان	زين
موسم	وسم
باع	بيع
صب	صبب
إسلام	سلم
آفة	ءوف
أيقن	يقن
أعجب	عجب
مبتدأ	بدء
محترف	حرف
عبد	عبد
سبح	سبح
أنفع	نفع
قرأ	قرء
غادر	غدر
جاء	جيء
لحظ	لحظ
مروحة	روح
حميد	حمد
عجوز	عجز
حكومة	حكم
راغ	روغ
صيف	صيف
ثمانية	ثمن
شرف	شرف
خالف	خلف
أبأس	بءس
كفف	كفف
لجء	لجء
حاول	حول
حذر	حذر
رهف	رهف
تلامس	لمس
شيول	شيل
بخيل	بخل
بكى	بكي
أمازيغ	زكو
ماض	مضي
مثقال	ثقل
مراقب	رقب
أفصح	فصح
لءلء	لءلء
صنم	صنم
هب	هبب
اعتقد	عقد
استسلم	سلم
معالجة	علج
نقيض	نقض
تقاطر	قطر
شهيةطيبة	شهو
تقسيم	قسم
قبح	قبح
حسن	حسن
حيرة	حير
كشف	كشف
نسى	نسي
استحال	حول
ابتزاز	بزز
حفاظ	حضر
فسقية	فسق
اقتنع	قنع
بحث	بحث
استقرأ	قرء
عاهرة	عهر
مقدم	قدم
القرآن	قرء
جمعة	جمع
عرقي	عرقي
تجاه	وجه
لطيف	لطف
زمن	زمن
مسح	مسح
أعذب	عذب
قوم	قوم
قشر	قشر
قافلة	قفل
متقون	وقي
تخبر	خبر
ميعاد	وعد
سمي	سمي
جمهورية	جمهر
قوم	قوم
أزرق	زرق
أبرد	برد
مؤامرة	ءمر
تعبد	عبد
أوسط	وسط
حاج	حجج
صيغة	صوغ
خجل	خجل
استبدال	بدل
محاسبة	حسب
دراس	درس
قرحة	قرح
مئذنة	ءذن
مبارز	برز
ماجد	مجد
نبيذ	نبذ
أليم	ءلم
أعقل	عقل
زنبور	زنب
نبي	نبو
هبط	هبط
انشق	شقق
منفصل	فصل
قوي	قوي
انعقد	عقد
قاتل	قتل
صحو	صحو
تعشيقة	عشق
محبوب	حبب
أمل	ءمل
معاصر	عصر
تمثال	مثل
تواجد	وجد
فرق	فرق
حرم	حرم
يرقان	ءرق
مزدهر	زهر
سول	سول
عسقل	عسقل
خطاب	خطب
زخ	زخخ
تعلم	علم
دمي	دمي
ناحية	نحو
نمق	نمق
ندو	ندو
أنبأ	نبء
وصاية	وصي
وجه	وجه
تبريك	برك
رام	روم
جنين	جنن
طري	طري
تماثل	مثل
صحى	صحو
عاقب	عقب
إفراغ	فرغ
صعق	صعق
حمق	حمق
تسرى	سرو
مرزوق	رزق
عدو	عدو
وجيز	وجز
مزرعة	زرع
بصق	بصق
صبر	صبر
خصم	خصم
تغريد	غرد
قدح	قدح
هدم	هدم
استحياء	حيو
أثمر	ثمر
أطرف	طرف
مبلغ	بلغ
تعصر	عصر
هاب	هيب
مركز	ركز
اعتدى	عدو
أعض	عضض
حشد	حشد
مجلس	جلس
اسبغل	سبغل
أغلم	غلم
استكثر	كثر
مكرم	كرم
لاحظ	لحظ
بيان	بين
إحصاء	حصو
اصطبر	صبر
دماغ	دمغ
جنازة	جنز
تعليم	علم
عصير	عصر
مدور	دور
صدر	صدر
نهضة	نهض
أقرض	قرض
عزف	عزف
صدم	صدم
حصوة	حصو
حور	حور
غلفة	غلف
محافظ	حفظ
ابتسامة	بسم
استحباب	حبب
زهر	زهر
خف	خفف
جنة	جنن
تحشد	حشد
مشى	مشي
شرب	شرب
انقلب	قلب
لهم	لهم
اغتيال	غول
خالق	خلق
والدة	ولد
سلك	سلك
زجاجة	زجج
ربط	ربط
عسمط	عسمط
تناقض	نقض
اعتمل	عمل
حقيقة	حقق
أمضى	مضي
مخدر	خدر
عطر	عطر
تمسيح	مسح
تسمع	سمع
بهج	بهج
مضارع	ضرع
فتاحة	فتح
ثمل	ثمل
فحش	فحش
أوسخ	وسخ
مذاكرة	ذكر
قرشح	قرشح
طلاء	طلي
رجع	رجع
مدينة	مدن
حظي	حظي
ختان	ختن
متنقض	نقض
نال	نيل
مزخرف	زخرف
اعتبار	عبر
دارجة	درج
استعرض	عرض
عجز	عجز
بذر	بذر
أخير	ءخر
تكتل	كتل
مفروغ	فرغ
عبو	عبو
استحضار	حضر
مثال	مثل
احرنفز	حرفز
احتساب	حسب
ذهب	ذهب
نصر	نصر
شيط	شيط
هدف	هدف
روحاني	روح
تال	تلو
قوس	قوس
واقعة	وقع
حقق	حقق
رسالة	رسل
خائف	خوف
عثق	عثق
بئيس	بءس
دهن	دهن
استهزأ	هزء
مرش	مرش
قر	قرر
نشاط	نشط
غرام	غرم
جبن	جبن
ساخر	سخر
احتكار	حكر
علوي	علو
أثناء	ثني
خلص	خلص
ءوب	ءوب
مكان	كون
قرح	قرح
مؤسسة	ءسس
نساء	نسء
عزم	عزم
قذيفة	قذف
تشوق	شوق
اباحي	بوح
حذف	حذف
غزارة	غزر
عشر	عشر
موطن	وطن
راجح	رجح
أشرط	شرط
نفق	نفق
سدر	سدر
قحزل	قحزل
إيتاء	ءتي
عرقل	عرقل
جرح	جرح
حاك	حوك
رأى	رءي
اخشوشب	خشب
وسام	وسم
هز	هزز
جلائل	جلل
مهندس	هندس
مسرح	سرح
كسر	كسر
حضر	حضر
سوط	سوط
تأوه	ءوه
رذ	رذذ
زلزال	زلزل
غضب	غضب
أمين	ءمن
مهمل	همل
إخمار	خمر
أكبر	كبر
أعقد	عقد
مهدي	هدي
تضامن	ضمن
وسوس	وسوس
رخصة	رخص
عمود	عمد
عربس	عربس
استمر	مرر
أحقر	حقر
تسامع	سمع
غموض	غمض
تراد	ردد
تاريخ	ءرخ
كرث	كرث
كلام	كلم
رحب	رحب
آمين	ءمن
مكتوب	كتب
سمك	سمك
أدفأ	دفء
خباز	خبز
قثقث	قثقث
مزح	مزح
دحض	دحض
قلل	قلل
مفت	فتو
مجيد	مجد
مستشفى	شفي
حفظ	حفظ
أصنع	صنع
تحابب	حبب
شعر	شعر
نبذ	نبذ
دهان	دهن
قبل	قبل
أراح	روح
محسن	حسن
مقالة	قول
استمنى	منو
حماس	حمس
كأس	كءس
لج	لجج
غفير	غفر
فاز	فوز
عذو	عذو
لقي	لقي
إحرام	حرم
عش	عشش
أكد	ءكد
محاضر	حضر
استعارات	عور
استقلال	قلل
مستقر	قرر
ظبي	ظبي
عدر	عدر
شفع	شفع
حداث	حدث
زميل	زمل
سوء	سوء
فقرة	فقر
نجد	جدد
منصف	نصف
إنقاض	نقض
انقاد	قود
حزب	حزب
رقبة	رقب
باحث	بحث
سورة	سور
غرق	غرق
متدين	دين
خسف	خسف
ثريد	ثرد
قنطار	قنطر
عبعب	عبعب
مفرغ	فرغ
بسط	بسط
فسفس	فسفس
أعجم	عجم
توازن	وزن
ترجمة	ترجم
أهدف	هدف
بار	بور
فشل	فشل
بزبز	بزبز
أعز	عزز
ميت	موت
استطال	طول
انجراف	جرف
أثر	ءثر
اثنونى	ثني
بلغ	بلغ
مقصود	قصد
ارتعد	رعد
أقدس	قدس
فوق	فوق
آمر	ءمر
قايس	قيس
غلام	غلم
كذاب	كذب
ردهة	رده
شارك	شرك
تواطؤ	وطء
بح	بحح
لبس	لبس
خلد	خلد
ليلة	ليل
حفار	حفر
غذى	غذو
ورث	ورث
رحلة	رحل
سأل	سءل
خريطة	خرط
مطلق	طلق
تشويق	شوق
حصي	حصي
قعر	قعر
فرس	فرس
عذلق	عذلق
أجر	ءجر
كتبي	كتب
إفلاس	فلس
تعزب	عزب
ثمر	ثمر
انتفض	نفض
قياس	قيس
كفل	كفل
مغذ	غذو
صباح	صبح
استنفاد	نفد
تعشق	عشق
इनाम	نعم
خالص	خلص
أعطى	عطو
دور	دور
طييرة	طير
جوال	جول
أثقل	ثقل
عربش	عربش
جزع	جزع
نهب	نهب
مبارك	برك
حدو	حدو
استقرض	قرض
غاضب	غضب
خلا	خلو
ناقض	نقض
برادة	برد
لحق	لحق
اكترب	كرب
صمد	صمد
تبليد	بلد
أذنب	ذنب
ولى	ولي
حياة	حيو
أعمق	عمق
توج	توج
تحدى	حدو
سلامة	سلم
صيام	صوم
احتمل	حمل
متفرغ	فرغ
قرص	قرص
اخروط	خرط
قتب	قتب
مرتب	رتب
إحسان	حسن
خلع	خلع
كامل	كمل
طائر	طير
أحدث	حدث
فاعل	فعل
ذبح	ذبح
تحقيق	حقق
كحل	كحل
وزير	وزر
تعالى	علي
واثق	وثق
أمير	ءمر
حساب	حسب
خر	خرر
زبد	زبد
رهين	رهن
خلق	خلق
بشر	بشر
نضد	نضد
علق	علق
شهيةطيبة	طيب
ثلج	ثلج
جدي	جدد
مناخ	نوخ
سلسلة	سلسل
متنوع	نوع
خنب	خنب
تواضع	وضع
أشغل	شغل
بدأ	بدء
ميمنة	يمن
طحينة	طحن
مساو	سوي
أهدأ	هدء
طب	طبب
ثنى	ثني
سيد	سود
تطاول	طول
شبكة	شبك
أحاديث	حدث
جبهة	جبه
تورع	ورع
اكتحل	كحل
نكس	نكس
نوع	نوع
سائل	سءل
تجمع	جمع
سياحة	سيح
ضبط	ضبط
عثم	عثم
رقص	رقص
قداحة	قدح
أجرة	ءجر
قرع	قرع
أفلح	فلح
تخشيب	خشب
استعمل	عمل
جدير	جدر
هذى	هذي
عذب	عذب
انقد	قدد
جريدة	جرد
شوق	شوق
مزدوج	زوج
سجن	سجن
جامع	جمع
أطرى	طرو
بطانة	بطن
جعل	جعل
قفر	قفر
ءسر	ءسر
فرغ	فرغ
دل	دلل
تمتع	متع
وضع	وضع
لطف	لطف
أيمن	يمن
رهيف	رهف
شي	شوي
استفهم	فهم
انتقاض	نقض
وطني	وطن
ماعزة	معز
صحة	صحح
ضريح	ضرح
سكان	سكن
بر	برر
مجاهد	جهد
صديق	صدق
شباك	شبك
حسبان	حسب
صوت	صوت
امتعض	معض
مؤمن	ءمن
شعلاء	شعل
عزل	عزل
أكرم	كرم
زانية	زني
تقول	قول
كاتب	كتب
سفر	سفر
ذخيرة	ذخر
أين	ءيي
ألفى	لفو
خلقة	خلق
تعرق	عرق
توقى	وقي
اهتز	هزز
سءل	سءل
اسلنطع	سلطع
تدخين	دخن
إدريس	درس
أمة	ءمم
مؤكل	ءكل
سار	سير
معلم	علم
أقفل	قفل
باكر	بكر
تبديل	بدل
جناح	جنح
عجج	عجج
استئمان	ءمن
أرخ	ءرخ
دهشة	دهش
قتن	قتن
عجز	عجز
هجوم	هجم
أصر	صرر
أومأ	ومء
قادم	قدم
تغير	غير
جلس	جلس
دف	دفف
عفوا	عفو
حادث	حدث
مزدحم	زحم
عطل	عطل
استحسن	حسن
كلم	كلم
سموم	سمم
جبة	جبب
شري	شري
أزيف	زيف
انقطع	قطع
هبب	هبب
ارتفاع	رفع
شتاء	شتو
دعوى	دعو
ثار	ثور
حلوى	حلو
مقهى	قهو
تكون	كون
شاذ	شذذ
ورد	ورد
عرين	عرن
منتظم	نظم
رضا	رضي
اخضر	خضر
جرى	جري
أعد	عدد
سراح	سرح
دفيء	دفء
أعان	عون
أميرة	ءمر
ملحون	لحن
مراجع	رجع
سائل	سيل
بحث	بحث
أرتب	رتب
عليم	علم
شجع	شجع
وثق	وثق
قهقه	قهقه
احتمال	حمل
حصر	حصر
قتم	قتم
فسح	فسح
سكة	سكك
رف	رفف
تبادل	بدل
فشو	فشو
رديء	ردء
تعدى	عدو
إختلال	خلل
فقد	فقد
تفاهة	تفه
طبب	طبب
جليل	جلل
بنى	بني
تدريس	درس
نجدي	نجد
خرئ	خرء
سما	سمو
أطوع	طوع
اعترف	عرف
تابع	تبع
إسراء	سري
تأويب	ءوب
مدرسة	درس
تولد	ولد
استفاد	فيد
أفطر	فطر
جرع	جرع
مناقشة	نقش
عاين	عين
حلب	حلب
حظ	حظظ
خفف	خفف
محفظة	حفظ
لكن	لكن
حبوباللقاح	حبب
أتي	ءتي
بول	بول
ترجمان	ترجم
عانى	عني
زاغ	زيغ
برك	برك
ترقيم	رقم
سالم	سلم
طري	طرو
قطع	قطع
حرق	حرق
أدان	دين
أبتر	بتر
مؤرخ	ءرخ
أدخل	دخل
فور	فور
أحمر	حمر
مقر	قرر
اشتباهی	شبه
مضر	ضرر
برأ	برء
عطس	عطس
مصرف	صرف
شهم	شهم
قتر	قتر
أزيد	زيد
مربك	ربك
مس	مسس
كفارة	كفر
قطب	قطب
توقيع	وقع
زراعي	زرع
آكل	ءكل
حل	حلل
اخضار	خضر
ليل	ليل
صنبور	صنبر
مدخل	دخل
حكمة	حكم
عثر	عثر
سجع	سجع
وعى	وعي
فسق	فسق
لهجة	لهج
شهر	شهر
سبع	سبع
صلى	صلو
مأتى	ءتي
حبس	حبس
لقف	لقف
اضرغط	ضرغط
مرر	مرر
عزب	عزب
مختبر	خبر
تنقض	نقض
مبنا	بني
عذف	عذف
مني	منو
صوة	صوي
قال	قول
تلعب	لعب
حط	حطط
ضمن	ضمن
ازرق	زرق
جان	جني
ملعقة	لعق
مقولة	قول
مؤاخذة	ءخذ
أفعى	فعو
عصر	عصر
قرصم	قرصم
معطل	عطل
إيماء	ومء
استشعار	شعر
مجوز	جوز
حنا	حني
قنع	قنع
رتب	رتب
عذم	عذم
بعد	بعد
طن	طنن
تعبان	تعب
أغمض	غمض
وحداني	وحد
نظف	نظف
دمية	دمي
تشريع	شرع
أداة	ءدو
أفلس	فلس
أصفر	صفر
سند	سند
نوش	نوش
نط	نطط
سليقة	سلق
مرآة	رءي
عاطف	عطف
خضل	خضل
توظيف	وظف
تخامر	خمر
لاحق	لحق
مهم	همم
شهل	شهل
تزمت	زمت
مستحب	حبب
آلة	ءول
جواد	جود
إله	ءله
مسئله	سءل
مطحنة	طحن
ولاية	ولي
بتول	بتل
تحد	حدو
ممنوع	منع
خوص	خوص
أرفع	رفع
شفة	شفه
بسيط	بسط
ساعد	سعد
ربض	ربض
برهن	برء
رد	ردد
لوث	لوث
علاوة	علو
وهن	وهن
نبذ	نبذ
عليا	علو
عامي	عمم
خمر	خمر
صحوة	صحو
مصباح	صبح
نطنيطة	نطنط
زريعة	زرع
مكون	كون
ميس	ميس
تضمن	ضمن
انبغى	بغي
مجال	جول
أمر	مرر
فصيلة	فصل
تكحل	كحل
داور	دور
سلخ	سلخ
أقوى	قوي
شعب	شعب
كمل	كمل
حق	حقق
غطى	غطو
أخطر	خطر
مقصر	قصر
شيع	شيع
توكد	وكد
رشد	رشد
فائز	فوز
قلة	قلل
زبرة	زبر
اختيار	خير
رحمن	رحم
مطاط	مطط
حديقة	حدق
تواطأ	وطء
قحبة	قحب
عبد	عبد
لقيت	لقي
سفط	سفط
سوي	سوي
استطرد	طرد
تلا	تلو
تمانية	ثمن
نصف	نصف
حصف	حصف
أقام	قوم
زنر	زنر
تكويت	كوت
خراب	خرب
لطف	لطف
حارس	حرس
جرؤ	جرء
أصغى	صغو
مادة	مدد
عصف	عصف
ربط	ربط
سائر	سير
مريح	روح
استدار	دور
رتل	رتل
درس	درس
موت	موت
مكتب	كتب
ذرأ	ذرء
إلغاء	لغو
لقاح	لقح
مخيم	خيم
عجو	عجو
شمع	شمع
التزم	لزم
أسر	سرر
عضض	عضض
خشب	خشب
أمرض	مرض
نير	نور
بهيج	بهج
عامر	عمر
عال	علي
تأبد	ءبد
تأمين	ءمن
أصاب	صوب
رجس	رجس
قحص	قحص
عرب	عرب
مرصاد	رصد
عاقبة	عقب
حصى	حصي
أسس	ءسس
كمال	كمل
رفع	رفع
وقت	وقت
تجمل	جمل
ضرع	ضرع
رهب	رهب
اعتقال	عقل
سقط	سقط
ألقى	لقي
قاض	قضي
استحيا	حيو
اقتتل	قتل
تحكيم	حكم
قول	قول
بني	بني
فرح	فرح
أحب	حبب
روح	روح
مسألة	سءل
كلف	كلف
سئم	سءم
تنصت	نصت
حمق	حمق
دهن	دهن
قحم	قحم
إدهاش	دهش
ضر	ضرر
دوي	دوي
تعزم	عزم
ماهر	مهر
تخضيل	خضل
انخرط	خرط
اثناء	ثني
مليح	ملح
أطعم	طعم
هرب	هرب
استرزق	رزق
معركة	عرك
تذكرة	ذكر
انشغل	شغل
ترادد	ردد
شاحب	شحب
عبل	عبل
مستوصف	وصف
ساند	سند
وفي	وفي
قحط	قحط
عجر	عجر
قثث	قثث
عير	عير
استصدر	صدر
طبیب	طبب
قثو	قثو
نافذة	نفذ
تلهم	لهم
بطؤ	بطء
جاز	جوز
غفل	غفل
قبص	قبص
عاش	عيش
قصد	قصد
أدرك	درك
اصفر	صفر
استزمر	زمر
مفيد	فيد
عثجل	عثجل
قدرالمستطاع	طوع
ضابط	ضبط
ساق	سقي
افترس	فرس
صحا	صحو
حمد	حمد
متابعة	تبع
قرض	قرض
مضمون	ضمن
استخفى	خفي
كتل	كتل
سمح	سمح
وظف	وظف
سلمات	سلم
ضمة	ضمم
تشرف	شرف
عنيف	عنف
اعتداء	عدو
ضحك	ضحك
عادة	عود
تصديق	صدق
ربطة	ربط
ملحن	لحن
رين	رين
